SendPacket,SendRate(Mb/s),FlightSize,ReceiveRate(Mb/s),Send Loss,Recv Loss,RTT(ms),CWnd,FlowWindow,Retrans,PktSndPeriod(us),RecvACK,RecvNAK,EstimatedBandwidth(Mb/s),Retrans_Total,NAK_TotalRecv,Total Send Loss,Total Recv Loss
619,2.08711,103,0,4,0,98.373,104,8189,4,0,184,4,3.37805,4,4,4,0
581,2.1188,130,0,12,0,159.809,130,8157,12,0,93,12,3.36346,16,16,16,0
702,2.56021,157,0,7,0,142.741,159,8191,7,0,134,7,3.48019,23,23,23,0
686,2.50127,177,0,31,0,160.886,177,8179,31,0,92,31,4.06387,54,54,54,0
409,1.49123,67,0,181,0,57.43,67,8189,181,0,85,4,3.99456,235,58,235,0
634,2.31221,115,0,6,0,142.739,120,8189,6,0,156,6,4.04928,241,64,241,0
704,2.56759,141,0,15,0,128.538,147,8159,15,0,114,15,4.77523,256,79,256,0
391,1.42599,75,0,156,0,68.938,75,8191,113,0,102,8,4.18061,369,87,412,0
679,2.47634,95,0,98,0,87.659,100,8189,17,0,218,6,3.86323,386,93,510,0
672,2.4508,133,0,9,0,163.891,133,8190,9,0,121,9,5.40269,395,102,519,0
754,2.74986,144,0,14,0,129.181,144,8150,14,0,46,14,4.62931,409,116,533,0
765,2.78972,122,0,21,0,118.578,153,8157,21,0,42,21,3.88147,430,137,554,0
506,1.84542,3,0,175,0,101.6,3,8036,125,0,11,20,3.94349,555,157,729,0
453,1.65216,36,0,74,0,41.732,36,8191,74,0,142,2,4.88102,629,159,803,0
557,2.03151,95,0,3,0,95.008,95,8189,3,0,178,3,4.79347,632,162,806,0
638,2.32682,132,0,7,0,118.953,135,8190,7,0,145,7,4.69133,639,169,813,0
628,2.29042,156,0,8,0,182.314,156,8137,8,0,98,8,4.98317,647,177,821,0
347,1.26549,31,0,168,0,56.583,31,8189,115,0,39,10,5.31149,762,187,989,0
639,2.33057,108,0,4,0,120.285,116,8191,4,0,195,4,4.70592,766,191,993,0
482,1.75795,90,0,120,0,92.256,90,8189,108,0,143,3,5.1072,874,194,1113,0
737,2.68799,130,0,9,0,158.314,142,8189,9,0,189,9,6.38765,883,203,1122,0
338,1.23269,42,0,150,0,46.516,42,8189,110,0,56,5,3.75379,993,208,1272,0
576,2.1006,71,0,84,0,53.943,71,8189,84,0,167,3,2.65939,1077,211,1356,0
665,2.42534,120,0,8,0,114.903,120,8190,8,0,148,8,3.9143,1085,219,1364,0
727,2.65122,144,0,15,0,134.268,144,8146,15,0,97,15,3.54221,1100,234,1379,0
437,1.59379,60,0,152,0,46.73,60,8191,112,0,75,7,4.0128,1212,241,1531,0
684,2.49447,114,0,7,0,137.253,120,8189,7,0,170,7,4.93939,1219,248,1538,0
672,2.45078,135,0,8,0,177.832,150,8191,8,0,127,8,4.67674,1227,256,1546,0
677,2.46897,161,0,22,0,157.577,170,8175,22,0,98,22,4.11859,1249,278,1568,0
352,1.28373,15,0,188,0,96.869,15,8191,188,0,22,14,3.99091,1437,292,1756,0
646,2.35603,108,0,7,0,126.74,113,8191,7,0,202,7,4.59283,1444,299,1763,0
644,2.34846,114,0,11,0,149.48,146,8190,11,0,132,11,4.31194,1455,310,1774,0
532,1.94029,3,0,168,0,138.879,3,8105,123,0,25,17,4.24262,1578,327,1942,0
559,2.03883,104,0,4,0,100.322,107,8189,3,0,192,4,3.79392,1581,331,1946,0
715,2.60761,141,0,12,0,123.267,141,8187,13,0,131,12,4.4761,1594,343,1958,0
620,2.26114,145,0,167,0,113.827,2,8177,126,0,18,22,4.63296,1720,365,2125,0
551,2.00955,101,0,6,0,110.724,101,8191,40,0,175,6,3.83405,1760,371,2131,0
484,1.7651,130,0,8,0,130.644,130,8150,8,0,104,8,3.71366,1768,379,2139,0
644,2.34875,103,0,134,0,79.157,103,8190,109,0,181,4,4.12224,1877,383,2273,0
719,2.62196,118,0,10,0,131.388,132,8191,10,0,106,10,4.80077,1887,393,2283,0
610,2.2246,145,0,25,0,106.082,145,8146,25,0,56,24,4.13318,1912,417,2308,0
562,2.04961,4,0,170,0,141.058,4,8190,115,0,75,10,3.22848,2027,427,2478,0
664,2.42161,110,0,6,0,106.111,110,8189,6,0,200,6,4.54906,2033,433,2484,0
462,1.68491,135,0,140,0,164.035,2,8157,109,0,98,5,4.91021,2142,438,2624,0
432,1.57551,20,0,82,0,66.577,20,8191,82,0,133,2,4.95398,2224,440,2706,0
645,2.35232,104,0,5,0,111.703,104,8191,5,0,167,5,5.87328,2229,445,2711,0
624,2.27569,117,0,4,0,160.949,140,8190,4,0,137,4,6.96038,2233,449,2715,0
468,1.70677,146,0,19,0,162.778,146,8191,19,0,25,19,5.60698,2252,468,2734,0
553,2.01691,89,0,150,0,82.131,89,8190,150,0,137,4,4.4615,2402,472,2884,0
686,2.50194,125,0,6,0,119.614,126,8189,6,0,125,6,4.68403,2408,478,2890,0
638,2.32682,105,0,8,0,154.515,142,8187,8,0,66,8,4.58189,2416,486,2898,0
669,2.43991,92,0,23,0,84.484,154,8191,23,0,58,23,2.66304,2439,509,2921,0
446,1.62653,33,0,168,0,61.822,33,8189,116,0,40,12,2.3639,2555,521,3089,0
679,2.47631,99,0,6,0,107.047,106,8189,6,0,160,6,3.97632,2561,527,3095,0
638,2.3268,121,0,6,0,152.984,142,8189,6,0,138,6,5.11085,2567,533,3101,0
471,1.71775,147,0,16,0,117.188,147,8172,16,0,22,16,5.20934,2583,549,3117,0
441,1.60825,19,0,225,0,67.748,19,8189,118,0,121,2,6.53357,2701,551,3342,0
727,2.65138,110,0,3,0,114.958,121,8189,3,0,225,3,4.85549,2704,554,3345,0
521,1.90007,93,0,126,0,107.86,93,8189,108,0,160,3,3.42912,2812,557,3471,0
695,2.53466,126,0,6,0,123.028,129,8189,6,0,124,6,3.03514,2818,563,3477,0
702,2.56034,151,0,16,0,122.926,151,8191,16,0,98,16,3.74285,2834,579,3493,0
688,2.50911,160,0,48,0,117.196,160,8177,48,0,42,46,4.79712,2882,625,3541,0
528,1.92563,75,0,176,0,61.632,75,8189,168,0,109,15,4.52717,3050,640,3717,0
575,2.09719,119,0,11,0,109.393,119,8190,11,0,133,11,4.61472,3061,651,3728,0
659,2.40339,128,0,23,0,92.188,128,8191,23,0,36,23,4.4615,3084,674,3751,0
641,2.33773,93,0,132,0,98.673,93,8111,114,0,149,4,4.3849,3198,678,3883,0
643,2.34503,116,0,8,0,165.339,131,8191,8,0,135,8,3.67718,3206,686,3891,0
605,2.20642,161,0,11,0,218.379,161,8189,11,0,136,11,4.13318,3217,697,3902,0
490,1.78708,3,0,191,0,135.555,3,8027,132,0,17,26,4.51987,3349,723,4093,0
560,2.04233,95,0,4,0,103.612,100,8189,4,0,170,4,3.95443,3353,727,4097,0
648,2.36316,138,0,11,0,150.84,138,8167,11,0,141,11,2.98406,3364,738,4108,0
557,2.03137,153,0,24,0,156.823,153,8164,24,0,69,24,3.15552,3388,762,4132,0
387,1.41141,77,0,155,0,81.691,77,8191,108,0,106,2,3.81216,3496,764,4287,0
620,2.26113,119,0,9,0,118.229,120,8191,9,0,132,9,3.71731,3505,773,4296,0
651,2.37423,141,0,10,0,179.07,149,8170,10,0,125,10,3.62611,3515,783,4306,0
776,2.83029,156,0,42,0,104.782,156,8178,42,0,34,42,3.99456,3557,825,4348,0
417,1.52069,16,0,188,0,92.914,16,8191,188,0,29,27,3.0023,3745,852,4536,0
670,2.44354,99,0,9,0,107.504,116,8191,9,0,211,9,2.63021,3754,861,4545,0
669,2.43999,124,0,12,0,129.22,143,8189,12,0,108,12,4.24262,3766,873,4557,0
691,2.5201,139,0,16,0,175.819,169,8147,16,0,126,16,4.66579,3782,889,4573,0
554,2.02045,142,0,206,0,133.757,4,8169,154,0,23,31,5.1145,3936,920,4779,0
589,2.14809,102,0,3,0,103.233,102,8138,55,0,174,3,4.49069,3991,923,4782,0
350,1.2764,28,0,124,0,77.869,28,8191,108,0,88,4,4.29005,4099,927,4906,0
493,1.79807,35,0,68,0,56.673,35,8189,68,0,181,1,5.60333,4167,928,4974,0
699,2.54943,114,0,1,0,127.701,114,8191,1,0,266,1,4.44691,4168,929,4975,0
693,2.52757,134,0,9,0,184.015,149,8191,9,0,147,9,4.1879,4177,938,4984,0
678,2.47265,169,0,26,0,152.026,169,8179,26,0,97,26,3.87418,4203,964,5010,0
446,1.62657,32,0,203,0,43.096,32,8189,135,0,45,28,4.26451,4338,992,5213,0
407,1.48428,37,0,78,0,35.68,37,8191,78,0,129,3,4.47974,4416,995,5291,0
573,2.08972,20,0,101,0,110.21,20,8189,101,0,163,3,5.05978,4517,998,5392,0
618,2.25372,110,0,7,0,106.52,110,8189,7,0,184,7,4.45421,4524,1005,5399,0
522,1.90377,135,0,8,0,155.402,135,8148,8,0,97,8,4.37395,4532,1013,5407,0
519,1.89277,87,0,138,0,90.861,87,8189,108,0,134,3,5.18016,4640,1016,5545,0
527,1.92208,35,0,161,0,44.215,35,8189,161,0,137,3,3.95078,4801,1019,5706,0
563,2.05324,39,0,79,0,42.766,39,8191,79,0,208,2,2.89651,4880,1021,5785,0
733,2.67323,126,0,5,0,109.5,126,8189,5,0,226,5,3.5495,4885,1026,5790,0
711,2.59302,144,0,13,0,116.875,144,8189,13,0,76,13,4.11494,4898,1039,5803,0
381,1.38958,148,0,27,0,126.779,148,8191,27,0,18,27,4.59283,4925,1066,5830,0
684,2.49447,103,0,153,0,84.998,103,8190,153,0,180,5,4.62202,5078,1071,5983,0
638,2.32679,139,0,8,0,148.796,139,8187,8,0,135,8,3.2832,5086,1079,5991,0
754,2.74976,154,0,18,0,128.81,154,8165,18,0,69,18,3.28685,5104,1097,6009,0
603,2.19913,160,0,22,0,118.742,160,8191,22,0,30,22,3.97267,5126,1119,6031,0
502,1.83078,29,0,232,0,51.535,29,8191,177,0,119,1,5.62886,5303,1120,6263,0
583,2.12619,5,0,91,0,112.054,5,8190,91,0,221,2,4.02739,5394,1122,6354,0
665,2.42524,110,0,3,0,140.147,110,8090,3,0,200,3,3.00595,5397,1125,6357,0
672,2.45079,104,0,15,0,114.901,141,8189,15,0,124,15,3.69542,5412,1140,6372,0
682,2.48696,154,0,23,0,138.373,154,8191,23,0,60,23,4.00915,5435,1163,6395,0
439,1.60103,59,0,167,0,39.492,59,8189,116,0,75,10,3.59693,5551,1173,6562,0
707,2.57858,123,0,8,0,126.576,123,8189,8,0,183,8,3.50938,5559,1181,6570,0
776,2.83007,130,0,8,0,148.268,154,8191,8,0,136,8,3.93984,5567,1189,6578,0
473,1.72497,3,0,183,0,146.064,3,8022,119,0,78,14,4.35206,5686,1203,6761,0
626,2.28303,96,0,3,0,131.04,110,8189,3,0,201,3,5.08531,5689,1206,6764,0
654,2.38512,123,0,11,0,152.954,144,8189,11,0,138,11,4.8409,5700,1217,6775,0
462,1.68491,75,0,146,0,69.204,75,8189,129,0,104,2,5.15098,5829,1219,6921,0
494,1.80162,67,0,95,0,76.837,67,8125,95,0,132,2,4.8409,5924,1221,7016,0
720,2.62584,103,0,4,0,143.763,130,8131,4,0,193,4,5.71277,5928,1225,7020,0
674,2.45825,144,0,23,0,129.108,144,8182,23,0,62,23,4.54541,5951,1248,7043,0
421,1.53542,3,0,175,0,108.044,3,8191,128,0,34,22,3.44736,6079,1270,7218,0
456,1.66295,94,0,6,0,98.321,94,8190,6,0,152,6,3.24307,6085,1276,7224,0
624,2.27589,92,0,97,0,91.11,92,8189,97,0,148,3,4.84454,6182,1279,7321,0
653,2.38142,131,0,7,0,152.565,131,8187,7,0,135,7,4.90291,6189,1286,7328,0
719,2.62234,163,0,13,0,173.08,163,8120,13,0,145,13,3.73555,6202,1299,7341,0
430,1.56821,5,0,178,0,154.958,5,8189,118,0,10,14,3.61152,6320,1313,7519,0
623,2.27223,104,0,6,0,69.274,108,8191,6,0,193,6,4.01645,6326,1319,7525,0
402,1.46605,6,0,134,0,151.105,6,8191,110,0,77,6,4.0128,6436,1325,7659,0
690,2.51659,111,0,7,0,111.133,111,8191,7,0,204,7,3.35616,6443,1332,7666,0
670,2.44363,115,0,11,0,144.278,141,8128,11,0,117,11,3.0169,6454,1343,7677,0
487,1.77611,64,0,148,0,60.764,64,8187,110,0,85,6,3.11904,6564,1349,7825,0
676,2.46537,120,0,5,0,146.452,125,8191,5,0,179,5,3.23942,6569,1354,7830,0
524,1.91101,142,0,13,0,135.727,142,8189,13,0,75,13,3.41818,6582,1367,7843,0
569,2.07515,83,0,229,0,89.769,2,8190,192,0,122,4,4.15142,6774,1371,8072,0
590,2.15173,107,0,4,0,110.324,110,8191,4,0,202,4,4.43232,6778,1375,8076,0
709,2.58571,125,0,13,0,119.985,144,8189,13,0,137,13,5.24218,6791,1388,8089,0
731,2.66595,131,0,15,0,149.364,165,8143,15,0,102,15,5.51578,6806,1403,8104,0
626,2.28309,170,0,47,0,114.505,170,8177,47,0,27,45,5.79667,6853,1448,8151,0
546,1.99124,88,0,173,0,77.916,88,8191,126,0,136,3,3.83405,6979,1451,8324,0
629,2.29399,120,0,8,0,141.775,138,8189,8,0,177,8,3.69907,6987,1459,8332,0
432,1.57551,58,0,157,0,170.717,3,8106,148,0,21,14,4.2025,7135,1473,8489,0
588,2.14434,93,0,3,0,98.153,102,8191,11,0,175,3,3.87418,7146,1476,8492,0
673,2.45451,131,0,11,0,87.876,131,8191,12,0,106,11,3.87782,7158,1487,8503,0
393,1.43328,38,0,142,0,44.693,38,8191,116,0,42,10,3.91066,7274,1497,8645,0
548,1.99862,20,0,102,0,93.137,20,8191,102,0,149,3,5.15462,7376,1500,8747,0
741,2.70247,108,0,6,0,118.888,111,8189,6,0,190,6,4.6585,7382,1506,8753,0
484,1.76516,135,0,9,0,128.469,135,8155,9,0,91,9,3.5641,7391,1515,8762,0
652,2.37784,103,0,137,0,100.071,105,8189,107,0,187,2,3.8231,7498,1517,8899,0
618,2.25388,118,0,11,0,101.188,123,8189,11,0,64,11,3.8304,7509,1528,8910,0
702,2.5601,127,0,11,0,155.33,157,8110,11,0,147,11,4.40678,7520,1539,8921,0
543,1.9805,3,0,182,0,152.086,3,8028,124,0,32,18,4.0201,7644,1557,9103,0
382,1.39316,94,0,1,0,99.167,94,8191,1,0,152,1,2.45146,7645,1558,9104,0
629,2.29392,133,0,10,0,126.226,133,8190,10,0,137,10,3.58963,7655,1568,9114,0
462,1.68491,78,0,134,0,57.331,78,8191,106,0,112,1,5.08896,7761,1569,9248,0
706,2.57466,129,0,12,0,101.113,129,8190,12,0,163,12,5.32243,7773,1581,9260,0
748,2.72813,153,0,13,0,132.803,153,8191,13,0,110,13,5.23123,7786,1594,9273,0
802,2.925,157,0,50,0,93.755,161,8172,49,0,39,49,3.80486,7835,1643,9323,0
434,1.58286,65,0,177,0,53.689,65,8191,178,0,84,14,3.44006,8013,1657,9500,0
653,2.38149,131,0,8,0,127.509,131,8191,8,0,204,8,5.016,8021,1665,9508,0
725,2.64406,104,0,5,0,175.652,180,8189,5,0,240,5,4.42502,8026,1670,9513,0
418,1.52444,3,0,205,0,155.455,3,8008,127,0,18,21,4.68403,8153,1691,9718,0
586,2.13714,107,0,3,0,108.268,107,8191,3,0,194,3,4.44691,8156,1694,9721,0
723,2.63679,139,0,11,0,136.025,143,8120,11,0,141,11,4.23168,8167,1705,9732,0
690,2.51643,121,0,8,0,183.921,172,8191,8,0,140,8,5.14368,8175,1713,9740,0
428,1.56098,59,0,178,0,54.034,59,8189,110,0,77,5,4.90656,8285,1718,9918,0
575,2.09704,73,0,87,0,72.942,73,8191,87,0,150,4,4.1952,8372,1722,10005,0
660,2.40702,97,0,88,0,99.904,97,8189,88,0,194,2,4.17331,8460,1724,10093,0
616,2.24667,91,0,111,0,77.853,91,8191,111,0,174,6,3.88147,8571,1730,10204,0
711,2.59298,118,0,12,0,131.331,135,8191,12,0,157,12,3.87418,8583,1742,10216,0
611,2.22839,150,0,19,0,140.775,150,8146,19,0,67,19,4.00186,8602,1761,10235,0
362,1.32021,72,0,152,0,68.417,72,8189,107,0,95,2,4.53811,8709,1763,10387,0
668,2.43628,122,0,9,0,105.996,122,8191,9,0,154,9,5.05248,8718,1772,10396,0
802,2.92495,149,0,12,0,146.81,149,8191,12,0,111,12,5.77478,8730,1784,10408,0
520,1.89645,153,0,28,0,104.62,153,8173,28,0,20,26,5.51578,8758,1810,10436,0
432,1.57552,85,0,154,0,94.507,85,8190,105,0,126,1,5.43917,8863,1811,10590,0
731,2.66595,137,0,8,0,119.856,137,8190,8,0,184,8,3.7465,8871,1819,10598,0
674,2.45803,163,0,9,0,173.12,163,8191,9,0,120,9,3.43277,8880,1828,10607,0
757,2.76085,182,0,15,0,169.445,182,8191,15,0,105,15,4.22803,8895,1843,10622,0
295,1.07588,58,0,184,0,60.19,58,8191,111,0,67,2,4.28275,9006,1845,10806,0
347,1.26553,36,0,69,0,105.457,36,8189,69,0,122,1,4.7351,9075,1846,10875,0
637,2.3232,110,0,4,0,115.337,110,8189,4,0,240,4,4.36301,9079,1850,10879,0
673,2.45445,143,0,6,0,159.378,145,8189,6,0,143,6,5.08166,9085,1856,10885,0
739,2.69507,164,0,20,0,133.403,164,8191,20,0,93,20,3.81946,9105,1876,10905,0
492,1.79432,49,0,181,0,43.182,49,8189,120,0,60,15,3.43642,9225,1891,11086,0
479,1.74689,36,0,73,0,49.433,36,8189,73,0,186,6,4.52352,9298,1897,11159,0
660,2.4072,99,0,8,0,119.048,99,8189,8,0,189,8,5.20205,9306,1905,11167,0
530,1.93303,135,0,7,0,169.425,135,8189,7,0,132,7,3.07162,9313,1912,11174,0
745,2.71703,143,0,13,0,104.817,152,8190,13,0,74,13,3.44736,9326,1925,11187,0
686,2.50178,115,0,11,0,152.294,163,8189,11,0,57,11,3.18106,9337,1936,11198,0
643,2.34502,169,0,36,0,123.304,169,8191,36,0,32,35,3.46925,9373,1971,11234,0
560,2.04232,86,0,171,0,81.08,86,8191,171,0,129,2,4.08941,9544,1973,11405,0
622,2.26843,129,0,9,0,134.598,129,8191,9,0,144,9,4.32288,9553,1982,11414,0
673,2.45444,149,0,10,0,154.796,149,8191,10,0,88,10,3.1008,9563,1992,11424,0
671,2.44714,155,0,23,0,133.975,155,8191,23,0,28,23,2.38944,9586,2015,11447,0
399,1.45512,79,0,159,0,83.91,79,8189,108,0,113,4,2.67398,9694,2019,11606,0
682,2.48728,121,0,6,0,146.164,129,8191,6,0,161,6,3.79392,9700,2025,11612,0
640,2.33409,156,0,13,0,150.056,156,8191,13,0,121,13,3.78298,9713,2038,11625,0
452,1.64844,88,0,157,0,85.625,88,8190,106,0,135,1,4.31923,9819,2039,11782,0
617,2.25019,127,0,7,0,114.394,127,8191,7,0,130,7,3.79392,9826,2046,11789,0
736,2.68417,154,0,7,0,174.901,154,8190,7,0,122,7,3.83405,9833,2053,11796,0
433,1.57916,3,0,172,0,138.718,3,8035,120,0,10,16,3.77933,9953,2069,11968,0
565,2.06066,109,0,3,0,134.01,109,8189,3,0,199,3,2.97677,9956,2072,11971,0
651,2.37421,107,0,7,0,200.831,147,8191,7,0,152,7,3.3817,9963,2079,11978,0
716,2.61126,154,0,12,0,134.85,154,8119,12,0,36,12,3.40723,9975,2091,11990,0
616,2.24656,160,0,44,0,108.418,160,8191,44,0,27,41,3.58963,10019,2132,12034,0
519,1.8928,85,0,162,0,97.378,85,8189,107,0,128,2,4.45421,10126,2134,12196,0
691,2.52001,112,0,6,0,150.794,133,8189,6,0,163,6,4.93939,10132,2140,12202,0
658,2.39968,152,0,16,0,112.338,152,8190,16,0,83,16,4.07482,10148,2156,12218,0
411,1.49893,77,0,156,0,82.628,77,8190,109,0,109,4,2.95488,10257,2160,12374,0
716,2.61126,116,0,6,0,145.427,124,8191,6,0,146,6,3.61517,10263,2166,12380,0
646,2.35598,157,0,12,0,185.698,157,8191,12,0,147,12,3.54586,10275,2178,12392,0
348,1.26916,69,0,159,0,59.312,69,8191,107,0,89,2,4.43962,10382,2180,12551,0
617,2.25018,124,0,9,0,123.277,124,8154,9,0,166,9,4.62566,10391,2189,12560,0
532,1.94018,90,0,127,0,79.733,90,8189,107,0,141,3,4.48339,10498,2192,12687,0
625,2.27948,128,0,10,0,153.048,128,8189,10,0,131,10,4.0055,10508,2202,12697,0
442,1.61209,17,0,148,0,81.264,17,8189,114,0,61,9,3.30874,10622,2211,12845,0
686,2.50184,116,0,3,0,120.537,116,8189,3,0,209,3,3.99456,10625,2214,12848,0
749,2.73163,141,0,15,0,144.63,141,8147,15,0,100,15,3.87053,10640,2229,12863,0
419,1.52806,66,0,149,0,69.155,66,8189,113,0,84,8,4.20979,10753,2237,13012,0
507,1.84904,85,0,86,0,98.669,85,8189,86,0,166,3,4.96493,10839,2240,13098,0
565,2.06067,120,0,10,0,164.85,123,8189,8,0,124,10,4.78982,10847,2250,13108,0
617,2.25018,110,0,11,0,171.647,150,8189,13,0,116,11,4.22074,10860,2261,13119,0
489,1.78333,122,0,175,0,162.148,3,8191,165,0,53,14,4.36301,11025,2275,13294,0
461,1.68126,34,0,71,0,44.261,34,8189,71,0,151,2,6.40224,11096,2277,13365,0
742,2.70607,103,0,3,0,120.644,104,8166,3,0,260,3,5.51578,11099,2280,13368,0
630,2.29762,121,0,14,0,105.775,129,8191,14,0,90,14,3.62976,11113,2294,13382,0
706,2.5748,118,0,14,0,141.051,153,8189,14,0,109,14,4.12954,11127,2308,13396,0
432,1.57551,3,0,176,0,131.788,3,8035,125,0,11,19,5.04154,11252,2327,13572,0
608,2.21739,103,0,3,0,139.032,106,8191,3,0,189,3,4.45421,11255,2330,13575,0
618,2.25376,132,0,142,0,139.122,2,8148,114,0,96,10,3.97997,11369,2340,13717,0
474,1.72879,94,0,6,0,98.949,94,8190,7,0,153,6,3.93254,11376,2346,13723,0
745,2.71715,136,0,8,0,135.133,136,8094,8,0,151,8,3.23578,11384,2354,13731,0
718,2.61863,152,0,28,0,112.814,152,8170,28,0,71,28,4.0201,11412,2382,13759,0
412,1.50258,3,0,221,0,94.204,3,8191,220,0,14,19,4.24992,11632,2401,13980,0
508,1.85272,32,0,0,0,54.187,32,8189,0,0,248,0,3.14458,11632,2401,13980,0
569,2.07516,73,0,1,0,83.96,73,8189,1,0,269,1,4.07846,11633,2402,13981,0
693,2.52737,119,0,8,0,155.483,128,8187,8,0,173,8,4.4615,11641,2410,13989,0
335,1.22181,38,0,143,0,51.642,38,8189,110,0,77,5,4.87373,11751,2415,14132,0
488,1.77973,43,0,75,0,54.249,43,8191,75,0,175,2,4.77523,11826,2417,14207,0
647,2.35953,104,0,4,0,125.938,109,8191,4,0,157,4,4.33382,11830,2421,14211,0
593,2.16268,136,0,10,0,121.734,136,8135,10,0,102,10,4.23898,11840,2431,14221,0
462,1.68489,4,0,213,0,76.697,4,8190,182,0,106,1,3.51667,12022,2432,14434,0
356,1.29839,7,0,74,0,54.969,7,8189,74,0,111,1,4.03469,12096,2433,14508,0
321,1.17068,19,0,0,0,44.614,19,8189,0,0,161,0,4.18061,12096,2433,14508,0
525,1.91466,30,0,0,0,41.066,30,8187,0,0,263,0,4.60013,12096,2433,14508,0
629,2.2941,59,0,1,0,67.075,59,8189,1,0,305,1,4.49434,12097,2434,14509,0
697,2.54217,109,0,7,0,127.343,109,8123,7,0,130,7,4.13318,12104,2441,14516,0
672,2.45091,111,0,4,0,128.266,148,8191,4,0,158,4,3.61882,12108,2445,14520,0
630,2.29758,160,0,27,0,109.236,160,8167,27,0,60,27,4.27181,12135,2472,14547,0
616,2.24658,93,0,163,0,97.283,95,8190,163,0,154,3,4.51622,12298,2475,14710,0
634,2.3122,105,0,11,0,168.145,135,8191,11,0,144,11,4.67674,12309,2486,14721,0
455,1.65938,147,0,22,0,126.038,147,8191,22,0,56,21,5.13638,12331,2507,14743,0
566,2.06437,85,0,151,0,83.674,85,8189,151,0,127,4,4.96858,12482,2511,14894,0
624,2.27574,125,0,11,0,98.083,125,8190,11,0,133,11,4.57094,12493,2522,14905,0
646,2.35596,148,0,15,0,143.099,148,8146,15,0,99,15,4.81901,12508,2537,14920,0
426,1.55361,16,0,171,0,89.936,16,8189,136,0,23,21,4.70592,12644,2558,15091,0
429,1.56456,37,0,77,0,40.796,37,8189,77,0,127,3,3.77203,12721,2561,15168,0
567,2.06784,106,0,4,0,98.325,106,8190,4,0,187,4,4.04198,12725,2565,15172,0
721,2.62954,119,0,7,0,152.822,141,8189,7,0,136,7,3.84134,12732,2572,15179,0
386,1.40774,48,0,152,0,42.529,48,8189,111,0,73,6,3.68448,12843,2578,15331,0
673,2.45434,116,0,9,0,118.598,116,8191,9,0,175,9,3.85958,12852,2587,15340,0
487,1.7762,53,0,131,0,43.57,53,8189,108,0,103,3,4.15872,12960,2590,15471,0
710,2.58948,102,0,9,0,109.646,120,8141,9,0,182,9,3.648,12969,2599,15480,0
612,2.232,151,0,7,0,174.516,151,8191,7,0,130,7,3.85594,12976,2606,15487,0
767,2.79724,165,0,22,0,145.452,165,8148,22,0,69,22,3.86323,12998,2628,15509,0
365,1.3312,49,0,173,0,46.743,49,8191,168,0,54,8,3.7392,13166,2636,15682,0
569,2.07514,21,0,106,0,82.301,21,8191,106,0,136,8,4.56365,13272,2644,15788,0
618,2.25381,45,0,96,0,45.248,45,8189,94,0,175,4,5.30054,13366,2648,15884,0
503,1.83444,36,0,65,0,57.723,36,8189,65,0,203,1,4.67309,13431,2649,15949,0
665,2.42527,107,0,3,0,116.128,107,8189,3,0,226,3,4.56,13434,2652,15952,0
625,2.27928,123,0,6,0,146.063,141,8189,6,0,134,6,4.71686,13440,2658,15958,0
684,2.49454,157,0,19,0,141.393,157,8191,19,0,73,19,4.06752,13459,2677,15977,0
405,1.47704,64,0,168,0,63.201,64,8191,115,0,82,11,3.98362,13574,2688,16145,0
639,2.33044,92,0,5,0,128.512,116,8189,5,0,146,5,4.71686,13579,2693,16150,0
665,2.42515,138,0,10,0,148.171,138,8169,10,0,87,10,5.63981,13589,2703,16160,0
613,2.23577,3,0,169,0,109.173,3,8047,129,0,26,24,4.96128,13718,2727,16329,0
475,1.7304,89,0,3,0,86.407,89,8190,3,0,138,3,4.29005,13721,2730,16332,0
687,2.50548,120,0,8,0,166.55,120,8191,8,0,99,8,4.1113,13729,2738,16340,0
697,2.54197,146,0,13,0,122.651,146,8189,13,0,109,13,4.26816,13742,2751,16353,0
727,2.65135,160,0,18,0,126.286,160,8190,18,0,70,18,3.70272,13760,2769,16371,0
550,2.00585,4,0,185,0,113.598,4,8133,184,0,17,22,4.104,13944,2791,16556,0
578,2.10771,98,0,8,0,120.91,98,8153,8,0,164,8,3.67354,13952,2799,16564,0
599,2.18471,107,0,8,0,148.34,127,8189,8,0,100,8,3.02054,13960,2807,16572,0
704,2.5675,147,0,14,0,115.826,147,8191,14,0,89,14,3.87782,13974,2821,16586,0
719,2.62218,155,0,49,0,98.201,155,8189,49,0,36,47,4.66579,14023,2868,16635,0
537,1.95852,90,0,157,0,87.259,90,8189,108,0,142,2,4.32288,14131,2870,16792,0
661,2.41042,131,0,10,0,138.397,131,8191,10,0,142,10,4.77523,14141,2880,16802,0
734,2.67709,141,0,21,0,108.914,141,8191,21,0,40,21,4.25722,14162,2901,16823,0
417,1.52081,18,0,162,0,76.833,18,8191,150,0,27,17,2.95853,14312,2918,16985,0
659,2.40338,102,0,7,0,109.989,102,8191,7,0,160,7,3.74285,14319,2925,16992,0
675,2.46171,100,0,10,0,156.642,144,8189,10,0,165,10,4.21709,14329,2935,17002,0
710,2.5889,157,0,25,0,136.125,157,8164,25,0,58,25,3.82675,14354,2960,17027,0
423,1.54212,16,0,186,0,87.682,18,8191,186,0,30,26,3.3671,14540,2986,17213,0
578,2.10789,103,0,110,0,119.596,2,8191,110,0,165,7,3.11174,14650,2993,17323,0
586,2.13714,100,0,2,0,88.611,101,8189,2,0,175,2,3.49843,14652,2995,17325,0
471,1.71721,7,0,127,0,129.801,9,8191,109,0,82,4,5.2823,14761,2999,17452,0
614,2.2391,106,0,6,0,102.694,106,8191,6,0,182,6,5.23853,14767,3005,17458,0
564,2.05699,54,0,123,0,47.112,54,8189,108,0,109,3,3.46195,14875,3008,17581,0
721,2.62965,122,0,7,0,120.576,126,8191,7,0,204,7,3.24672,14882,3015,17588,0
616,2.24653,151,0,160,0,140.001,2,8189,113,0,110,9,4.4615,14995,3024,17748,0
538,1.96216,90,0,3,0,93.453,90,8191,16,0,142,3,3.54221,15011,3027,17751,0
641,2.33767,118,0,8,0,135.724,130,8108,8,0,138,8,3.22118,15019,3035,17759,0
589,2.14825,156,0,6,0,154.685,156,8190,6,0,116,6,3.86323,15025,3041,17765,0
557,2.0314,91,0,159,0,116.58,91,8190,107,0,143,3,4.63661,15132,3044,17924,0
630,2.29775,125,0,13,0,152.501,126,8170,13,0,120,13,4.21709,15145,3057,17937,0
694,2.53101,141,0,22,0,128.797,141,8159,22,0,64,22,3.99821,15167,3079,17959,0
430,1.56826,12,0,172,0,85.688,12,8189,134,0,23,27,3.79027,15301,3106,18131,0
657,2.39619,111,0,7,0,107.124,111,8191,7,0,196,7,3.32698,15308,3113,18138,0
627,2.28668,103,0,10,0,184.032,145,8189,10,0,137,10,4.28275,15318,3123,18148,0
355,1.2948,53,0,151,0,41.387,53,8191,110,0,62,5,4.42138,15428,3128,18299,0
675,2.46175,127,0,5,0,133.037,127,8189,5,0,209,5,4.59648,15433,3133,18304,0
680,2.47995,151,0,20,0,144.611,151,8191,20,0,105,20,4.40314,15453,3153,18324,0
597,2.17735,4,0,194,0,108.578,4,8098,194,0,26,38,4.63661,15647,3191,18518,0
494,1.80172,99,0,5,0,101.626,99,8189,5,0,167,5,4.02374,15652,3196,18523,0
724,2.64036,134,0,11,0,139.411,134,8153,11,0,126,11,4.2937,15663,3207,18534,0
642,2.34085,164,0,8,0,167.866,164,8190,8,0,138,8,4.3849,15671,3215,18542,0
706,2.57448,168,0,34,0,129.166,168,8173,34,0,21,32,3.17741,15705,3247,18576,0
467,1.70311,90,0,170,0,95.607,90,8191,107,0,142,2,4.00186,15812,3249,18746,0
658,2.39982,134,0,15,0,131.197,134,8191,15,0,154,15,6.43142,15827,3264,18761,0
717,2.61491,147,0,19,0,136.648,147,8163,19,0,56,19,5.1072,15846,3283,18780,0
399,1.4549,17,0,172,0,69.689,17,8191,128,0,27,23,4.28275,15974,3306,18952,0
522,1.90374,30,0,89,0,60.474,30,8191,89,0,141,4,4.61472,16063,3310,19041,0
739,2.69529,104,0,8,0,119.588,117,8191,8,0,199,8,5.5559,16071,3318,19049,0
562,2.04965,144,0,13,0,139.91,144,8189,13,0,111,13,5.44646,16084,3331,19062,0
408,1.48796,11,0,152,0,109.054,11,8189,112,0,16,7,4.63661,16196,3338,19214,0
617,2.24964,106,0,6,0,114.98,106,8191,6,0,181,6,3.98726,16202,3344,19220,0
775,2.82661,140,0,12,0,134.383,140,8191,12,0,131,12,4.39219,16214,3356,19232,0
541,1.97311,145,0,179,0,98.199,2,8191,79,0,21,33,4.22438,16293,3389,19411,0
592,2.15904,93,0,3,0,91.175,95,8191,63,0,156,3,4.70227,16356,3392,19414,0
530,1.93278,88,0,103,0,87.955,88,8191,103,0,141,6,4.15872,16459,3398,19517,0
637,2.32319,131,0,11,0,132.39,131,8191,11,0,148,11,2.99501,16470,3409,19528,0
753,2.74618,156,0,10,0,155.929,156,8190,10,0,109,10,4.98682,16480,3419,19538,0
831,3.03077,175,0,22,0,109.387,175,8172,22,0,100,22,5.38445,16502,3441,19560,0
396,1.44366,53,0,192,0,42.304,53,8190,127,0,63,16,4.48339,16629,3457,19752,0
626,2.28305,76,0,93,0,82.288,76,8189,93,0,186,3,4.00186,16722,3460,19845,0
622,2.26841,115,0,9,0,124.9,115,8119,9,0,117,9,4.104,16731,3469,19854,0
730,2.66223,147,0,11,0,138.132,147,8190,11,0,132,11,4.90291,16742,3480,19865,0
666,2.42891,164,0,26,0,149.776,164,8191,26,0,82,26,5.40634,16768,3506,19891,0
387,1.41139,16,0,192,0,91.695,16,8191,178,0,27,25,5.0087,16946,3531,20083,0
690,2.51662,105,0,9,0,110.273,105,8138,9,0,172,9,5.39904,16955,3540,20092,0
421,1.53485,64,0,119,0,71.259,64,8191,108,0,118,3,5.89152,17063,3543,20211,0
664,2.42157,4,0,119,0,112.805,4,8099,99,0,142,5,4.36666,17162,3548,20330,0
411,1.49891,15,0,73,0,68.555,15,8189,73,0,105,2,3.85958,17235,3550,20403,0
669,2.43988,98,0,3,0,95.404,98,8189,3,0,260,3,3.69907,17238,3553,20406,0
478,1.74328,127,0,7,0,136.994,127,8146,7,0,100,7,4.06387,17245,3560,20413,0
606,2.21009,94,0,131,0,113.051,99,8191,109,0,167,4,5.23488,17354,3564,20544,0
615,2.24297,131,0,9,0,140.398,134,8189,9,0,127,9,4.18061,17363,3573,20553,0
388,1.41505,64,0,142,0,92.048,64,8189,109,0,97,4,3.28685,17472,3577,20695,0
605,2.20652,77,0,87,0,68.874,77,8191,87,0,154,3,4.60378,17559,3580,20782,0
645,2.35234,124,0,8,0,134.372,125,8189,8,0,150,8,4.72051,17567,3588,20790,0
678,2.47267,126,0,12,0,168.009,155,8191,12,0,132,12,5.6617,17579,3600,20802,0
399,1.45505,54,0,167,0,48.516,54,8189,108,0,104,3,4.7351,17687,3603,20969,0
643,2.34508,107,0,6,0,108.962,107,8191,6,0,136,6,3.55315,17693,3609,20975,0
732,2.66976,147,0,5,0,79.205,152,8191,5,0,179,5,4.22438,17698,3614,20980,0
341,1.24366,10,0,162,0,116.095,10,8191,115,0,12,10,3.99821,17813,3624,21142,0
619,2.25762,114,0,2,0,137.933,118,8187,2,0,226,2,4.55635,17815,3626,21144,0
642,2.34137,142,0,15,0,153.535,142,8170,15,0,97,15,4.8263,17830,3641,21159,0
329,1.19986,32,0,148,0,59.483,32,8191,110,0,35,5,3.18835,17940,3646,21307,0
680,2.47997,105,0,5,0,120.553,121,8187,5,0,215,5,2.71411,17945,3651,21312,0
746,2.71936,122,0,16,0,120.697,135,8191,16,0,56,16,4.42138,17961,3667,21328,0
666,2.42889,150,0,16,0,153.14,150,8160,16,0,64,16,4.50163,17977,3683,21344,0
437,1.59363,7,0,178,0,109.755,7,8189,131,0,17,26,4.4688,18108,3709,21522,0
643,2.34501,118,0,4,0,147.946,118,8191,4,0,227,4,3.77933,18112,3713,21526,0
679,2.47631,150,0,10,0,160.829,150,8189,9,0,134,10,3.62976,18121,3723,21536,0
734,2.67689,160,0,33,0,130.264,160,8191,34,0,49,30,4.43962,18155,3753,21569,0
432,1.57555,60,0,180,0,49.398,60,8191,123,0,81,17,4.43232,18278,3770,21749,0
660,2.40716,116,0,6,0,135.347,118,8191,6,0,162,6,3.27955,18284,3776,21755,0
679,2.47375,149,0,11,0,149.533,149,8163,11,0,128,11,3.9216,18295,3787,21766,0
414,1.50987,24,0,170,0,62.433,24,8189,124,0,32,19,4.00186,18419,3806,21936,0
717,2.61487,110,0,5,0,113.185,112,8191,5,0,189,5,4.73146,18424,3811,21941,0
619,2.25751,146,0,8,0,166.181,146,8191,8,0,135,8,4.43232,18432,3819,21949,0
722,2.63311,164,0,31,0,128.643,164,8177,31,0,91,31,3.86688,18463,3850,21980,0
425,1.54996,72,0,171,0,72.335,72,8189,112,0,95,7,3.57139,18575,3857,22151,0
705,2.57125,138,0,9,0,119.904,138,8189,9,0,219,9,4.30829,18584,3866,22160,0
659,2.40335,114,0,14,0,176.234,155,8191,14,0,76,14,4.54176,18598,3880,22174,0
566,2.06421,160,0,39,0,133.476,160,8191,39,0,24,39,3.70637,18637,3919,22213,0
416,1.51724,82,0,160,0,76.523,82,8189,104,0,120,0,2.30554,18741,3919,22373,0
544,1.98403,117,0,127,0,115.324,2,8191,115,0,108,10,3.65165,18856,3929,22500,0
503,1.83457,92,0,3,0,84.656,92,8191,3,0,146,3,3.98726,18859,3932,22503,0
643,2.34517,134,0,6,0,163.277,134,8191,6,0,148,6,5.52672,18865,3938,22509,0
492,1.79439,87,0,136,0,80.672,87,8189,106,0,133,2,4.85914,18971,3940,22645,0
562,2.0497,113,0,6,0,153.046,125,8189,6,0,125,6,4.0967,18977,3946,22651,0
576,2.10076,146,0,15,0,161.84,146,8134,15,0,90,15,4.34112,18992,3961,22666,0
474,1.72868,76,0,148,0,76.507,76,8191,129,0,104,2,5.45741,19121,3963,22814,0
498,1.8162,5,0,120,0,128.01,5,8189,108,0,126,3,6.07027,19229,3966,22934,0
694,2.53104,111,0,3,0,94.611,114,8189,3,0,215,3,4.9248,19232,3969,22937,0
477,1.73963,71,0,126,0,81.512,71,8191,108,0,120,4,4.79347,19340,3973,23063,0
586,2.13714,86,0,92,0,71.495,86,8189,92,0,173,4,3.78298,19432,3977,23155,0
550,2.00587,104,0,88,0,110.581,104,8189,88,0,185,2,4.97952,19520,3979,23243,0
728,2.65502,119,0,11,0,117.531,134,8191,11,0,109,11,5.78208,19531,3990,23254,0
729,2.65867,160,0,11,0,132.502,160,8191,11,0,119,11,6.32198,19542,4001,23265,0
353,1.28745,63,0,167,0,55.66,63,8191,112,0,77,7,6.1943,19654,4008,23432,0
663,2.41801,123,0,7,0,147.345,123,8190,7,0,176,7,4.12224,19661,4015,23439,0
651,2.37437,146,0,13,0,161.426,146,8165,13,0,95,13,4.3703,19674,4028,23452,0
713,2.60048,154,0,59,0,102.501,154,8172,59,0,39,56,3.76474,19733,4084,23511,0
512,1.86735,89,0,163,0,92.174,89,8191,163,0,137,7,3.68083,19896,4091,23674,0
623,2.27211,107,0,4,0,114.965,121,8189,4,0,107,4,4.03469,19900,4095,23678,0
719,2.62217,140,0,12,0,142.133,150,8189,12,0,123,12,4.10035,19912,4107,23690,0
498,1.81623,3,0,174,0,186.096,3,8191,116,0,65,11,3.87053,20028,4118,23864,0
617,2.25019,110,0,2,0,98.443,112,8189,2,0,211,2,3.2905,20030,4120,23866,0
592,2.15904,140,0,12,0,159.065,140,8191,12,0,109,12,3.8377,20042,4132,23878,0
640,2.33416,145,0,186,0,92.213,2,8169,145,0,24,38,3.79757,20187,4170,24064,0
498,1.81621,99,0,4,0,117.859,99,8191,5,0,169,4,3.1993,20192,4174,24068,0
740,2.69888,114,0,8,0,133.586,137,8191,8,0,140,8,4.87373,20200,4182,24076,0
648,2.36335,149,0,20,0,129.74,149,8160,20,0,51,19,3.72461,20220,4201,24096,0
428,1.56092,49,0,169,0,41.74,49,8191,124,0,59,18,3.42547,20344,4219,24265,0
702,2.56024,104,0,7,0,119.701,123,8189,7,0,198,7,4.25357,20351,4226,24272,0
662,2.41431,146,0,16,0,154.362,147,8191,16,0,101,16,4.49798,20367,4242,24288,0
392,1.42963,39,0,163,0,43.491,39,8191,121,0,42,16,4.4761,20488,4258,24451,0
679,2.4764,38,0,118,0,89.331,3,8115,91,0,181,6,3.79392,20579,4264,24569,0
531,1.93664,95,0,3,0,111.428,95,8189,30,0,153,3,2.95488,20609,4267,24572,0
771,2.8119,126,0,10,0,134.787,128,8191,10,0,115,10,3.81946,20619,4277,24582,0
677,2.4691,158,0,8,0,172.657,158,8114,8,0,134,8,5.04883,20627,4285,24590,0
441,1.60846,71,0,163,0,67.475,71,8191,110,0,95,5,5.04154,20737,4290,24753,0
591,2.15545,112,0,10,0,110.862,112,8128,10,0,117,10,4.54541,20747,4300,24763,0
633,2.3086,73,0,126,0,67.616,73,8189,111,0,141,5,3.41453,20858,4305,24889,0
658,2.39979,105,0,8,0,121.216,114,8189,8,0,120,8,4.31558,20866,4313,24897,0
624,2.2759,147,0,8,0,169.287,147,8166,8,0,136,8,4.94304,20874,4321,24905,0
457,1.66671,150,0,168,0,152.641,2,8191,122,0,14,18,5.00506,20996,4339,25073,0
550,2.00581,95,0,3,0,115.691,95,8190,4,0,156,3,4.89562,21000,4342,25076,0
625,2.27955,133,0,6,0,119.572,133,8190,6,0,136,6,4.07846,21006,4348,25082,0
635,2.31592,156,0,9,0,157.415,156,8155,9,0,103,9,4.79712,21015,4357,25091,0
445,1.62292,159,0,27,0,133.692,159,8191,27,0,17,27,4.58918,21042,4384,25118,0
645,2.35231,101,0,160,0,97.75,106,8189,106,0,191,1,3.52032,21148,4385,25278,0
615,2.24287,131,0,15,0,110.801,131,8190,15,0,91,15,2.98771,21163,4400,25293,0
707,2.57853,139,0,12,0,134.218,162,8190,12,0,144,12,4.68038,21175,4412,25305,0
673,2.45457,68,0,193,0,112.097,4,8141,188,0,20,27,5.32608,21363,4439,25498,0
466,1.6996,94,0,5,0,103.827,94,8189,10,0,151,5,3.71366,21373,4444,25503,0
644,2.34869,124,0,135,0,131.657,2,8191,115,0,102,11,3.53856,21488,4455,25638,0
477,1.7396,96,0,4,0,86.544,96,8190,5,0,159,4,3.60422,21493,4459,25642,0
696,2.53821,137,0,7,0,116.328,137,8144,7,0,151,7,2.93299,21500,4466,25649,0
707,2.57845,143,0,11,0,172.023,159,8159,11,0,102,11,3.08621,21511,4477,25660,0
580,2.11525,164,0,42,0,117.844,164,8185,42,0,26,42,3.54221,21553,4519,25702,0
592,2.15902,83,0,170,0,77.615,83,8128,160,0,121,6,3.78662,21713,4525,25872,0
589,2.14813,126,0,8,0,138.995,126,8191,8,0,141,8,3.60058,21721,4533,25880,0
440,1.60468,74,0,129,0,82.476,74,8124,109,0,100,3,3.57869,21830,4536,26009,0
644,2.34859,119,0,8,0,131.859,124,8191,8,0,155,8,4.06387,21838,4544,26017,0
547,1.99493,143,0,11,0,161.306,143,8191,11,0,79,11,3.1993,21849,4555,26028,0
453,1.65219,4,0,219,0,76.712,4,8191,181,0,104,1,4.68403,22030,4556,26247,0
596,2.17366,91,0,5,0,117.197,91,8189,5,0,180,5,5.40998,22035,4561,26252,0
623,2.27214,126,0,12,0,126.613,126,8153,12,0,117,12,5.42093,22047,4573,26264,0
367,1.3385,59,0,132,0,53.754,59,8191,111,0,71,6,4.04563,22158,4579,26396,0
612,2.23202,36,0,59,0,41.33,36,8189,59,0,264,0,3.2905,22217,4579,26455,0
610,2.22461,7,0,100,0,108.258,7,8189,100,0,194,4,3.58234,22317,4583,26555,0
674,2.45808,102,0,4,0,122.358,102,8189,4,0,171,4,3.93619,22321,4587,26559,0
613,2.23571,130,0,7,0,126.116,134,8189,7,0,120,7,3.46925,22328,4594,26566,0
683,2.49095,159,0,12,0,149.759,159,8189,12,0,115,12,4.25357,22340,4606,26578,0
413,1.50618,72,0,165,0,69.781,72,8190,111,0,97,6,3.66989,22451,4612,26743,0
543,1.9804,86,0,73,0,102.335,86,8189,73,0,201,1,3.58598,22524,4613,26816,0
535,1.95101,122,0,8,0,130.517,122,8118,8,0,118,8,4.0201,22532,4621,26824,0
531,1.93656,89,0,125,0,91.809,89,8191,108,0,139,3,4.34842,22640,4624,26949,0
626,2.28311,131,0,6,0,118.262,131,8191,6,0,143,6,6.16147,22646,4630,26955,0
720,2.62575,153,0,12,0,174.797,153,8101,12,0,98,12,4.70227,22658,4642,26967,0
752,2.74247,167,0,12,0,193.552,172,8189,12,0,99,12,4.89926,22670,4654,26979,0
613,2.23557,189,0,16,0,123.866,193,8191,16,0,120,16,4.13318,22686,4670,26995,0
371,1.35308,66,0,203,0,63.769,66,8191,114,0,89,9,4.22074,22800,4679,27198,0
603,2.19927,110,0,10,0,119.392,110,8191,10,0,122,10,3.82675,22810,4689,27208,0
755,2.75367,111,0,9,0,142.183,150,8189,9,0,161,9,3.29414,22819,4698,27217,0
697,2.54212,136,0,17,0,135.96,165,8190,17,0,74,17,3.8377,22836,4715,27234,0
609,2.22102,171,0,44,0,103.924,171,8182,44,0,30,43,4.68403,22880,4758,27278,0
604,2.20278,88,0,177,0,116.189,100,8191,123,0,170,6,4.80442,23003,4764,27455,0
630,2.29778,120,0,12,0,184.267,135,8189,13,0,130,12,5.17651,23016,4776,27467,0
611,2.22835,164,0,14,0,151.853,164,8190,14,0,134,14,4.25357,23030,4790,27481,0
451,1.64478,22,0,185,0,80.906,22,8189,123,0,31,19,3.5568,23153,4809,27666,0
725,2.64409,116,0,4,0,127.075,120,8189,4,0,219,4,4.08211,23157,4813,27670,0
648,2.36313,110,0,10,0,163.302,150,8189,10,0,128,10,5.06707,23167,4823,27680,0
686,2.50183,162,0,25,0,125.234,162,8172,25,0,58,25,4.80806,23192,4848,27705,0
354,1.29103,67,0,171,0,61.27,67,8189,115,0,85,9,4.42867,23307,4857,27876,0
632,2.30491,115,0,7,0,126.016,122,8189,7,0,163,7,4.38854,23314,4864,27883,0
691,2.52006,105,0,8,0,169.127,157,8189,8,0,155,8,5.1984,23322,4872,27891,0
397,1.4478,3,0,174,0,152.987,3,8191,119,0,14,14,5.45011,23441,4886,28065,0
523,1.90752,102,0,5,0,114.007,102,8189,5,0,177,5,3.7392,23446,4891,28070,0
665,2.42539,134,0,9,0,137.248,134,8191,9,0,116,9,3.2759,23455,4900,28079,0
407,1.48433,80,0,137,0,92.686,80,8191,107,0,115,3,3.51302,23562,4903,28216,0
586,2.13706,122,0,10,0,112.239,122,8191,10,0,133,10,3.44371,23572,4913,28226,0
455,1.65939,135,0,13,0,147.646,135,8177,13,0,50,13,3.14822,23585,4926,28239,0
587,2.14077,97,0,136,0,112.942,101,8191,105,0,173,1,3.80486,23690,4927,28375,0
435,1.58638,14,0,122,0,100.128,14,8191,112,0,60,7,4.21709,23802,4934,28497,0
657,2.39619,100,0,5,0,118.213,113,8191,5,0,203,5,4.72416,23807,4939,28502,0
657,2.39607,119,0,8,0,157.789,147,8189,8,0,139,8,5.48294,23815,4947,28510,0
569,2.07515,154,0,33,0,132.037,154,8164,33,0,31,33,5.30419,23848,4980,28543,0
466,1.6995,72,0,159,0,101.743,72,8189,159,0,95,5,5.09626,24007,4985,28702,0
604,2.2029,114,0,12,0,114.137,117,8191,12,0,132,12,4.96128,24019,4997,28714,0
493,1.79792,3,0,148,0,154.455,3,8191,112,0,101,7,4.71686,24131,5004,28862,0
511,1.8636,96,0,3,0,128.514,100,8189,2,0,171,3,4.34477,24133,5007,28865,0
640,2.33408,132,0,10,0,155.279,132,8191,11,0,117,10,4.9248,24144,5017,28875,0
687,2.50563,150,0,18,0,138.046,150,8168,18,0,80,18,5.35162,24162,5035,28893,0
522,1.90379,56,0,164,0,45.286,56,8191,146,0,72,12,3.9216,24308,5047,29057,0
651,2.37418,104,0,6,0,141.592,128,8191,5,0,206,6,4.52352,24313,5053,29063,0
728,2.65494,139,0,14,0,120.07,146,8190,15,0,80,14,5.5705,24328,5067,29077,0
333,1.21435,20,0,156,0,67.552,20,8191,114,0,23,9,5.69453,24442,5076,29233,0
640,2.33417,45,0,99,0,41.757,45,8189,99,0,182,4,5.27136,24541,5080,29332,0
577,2.10428,37,0,69,0,44.255,37,8189,69,0,231,2,3.9143,24610,5082,29401,0
658,2.39971,115,0,8,0,111.918,115,8189,8,0,203,8,4.03834,24618,5090,29409,0
663,2.41815,148,0,10,0,175.063,148,8190,10,0,133,10,4.33018,24628,5100,29419,0
379,1.38221,3,0,168,0,181.203,3,8034,115,0,45,11,3.7392,24743,5111,29587,0
558,2.03501,104,0,2,0,114.682,108,8189,2,0,197,2,3.29414,24745,5113,29589,0
668,2.4363,121,0,10,0,105.418,132,8189,10,0,90,10,3.44006,24755,5123,29599,0
650,2.37068,116,0,11,0,148.177,156,8189,11,0,107,11,3.8377,24766,5134,29610,0
477,1.73962,160,0,33,0,114.745,160,8173,33,0,21,33,3.54586,24799,5167,29643,0
601,2.19182,88,0,164,0,85.639,88,8191,110,0,136,4,4.49798,24909,5171,29807,0
446,1.62654,3,0,167,0,78.263,2,8126,167,0,109,2,5.23123,25076,5173,29974,0
193,0.703913,14,0,0,0,32.929,14,8189,0,0,99,0,4.64026,25076,5173,29974,0
463,1.68857,25,0,0,0,34.669,25,8191,0,0,231,0,5.60333,25076,5173,29974,0
601,2.19195,35,0,0,0,45.366,35,8179,0,0,303,0,3.75744,25076,5173,29974,0
660,2.4072,101,0,2,0,110.311,104,8189,2,0,234,2,4.05293,25078,5175,29976,0
662,2.41427,111,0,21,0,118.131,127,8189,21,0,82,21,4.72781,25099,5196,29997,0
535,1.95106,122,0,8,0,157.516,155,8191,8,0,124,8,4.72781,25107,5204,30005,0
0,0,122,0,0,0,157.516,155,8191,0,0,0,0,4.72781,25107,5204,30005,0
84,0.306349,115,0,121,0,156.872,2,8191,83,0,4,0,4.72781,25190,5204,30126,0
0,0,115,0,0,0,156.872,2,8191,0,0,0,0,4.72781,25190,5204,30126,0
243,0.886223,66,0,51,0,91.186,66,8189,88,0,83,1,5.76384,25278,5205,30177,0
611,2.22831,125,0,6,0,141.071,125,8190,6,0,175,6,5.68723,25284,5211,30183,0
603,2.19922,147,0,10,0,148.738,147,8191,10,0,95,10,3.86323,25294,5221,30193,0
698,2.54572,169,0,14,0,122.607,169,8191,14,0,109,14,3.61517,25308,5235,30207,0
309,1.12695,171,0,11,0,165.073,171,8191,11,0,9,11,5.13274,25319,5246,30218,0
388,1.41507,65,0,171,0,102.383,65,8191,171,0,81,0,6.87648,25490,5246,30389,0
560,2.04244,127,0,3,0,166.125,130,8189,3,0,196,3,6.86554,25493,5249,30392,0
677,2.46919,151,0,15,0,152.511,154,8189,15,0,108,15,4.84454,25508,5264,30407,0
669,2.43994,193,0,5,0,254.742,197,8185,5,0,237,5,5.69818,25513,5269,30412,0
571,2.08253,220,0,12,0,245.688,220,8191,12,0,153,12,7.04429,25525,5281,30424,0
657,2.39601,235,0,11,0,247.552,235,8189,11,0,102,11,7.48205,25536,5292,30435,0
505,1.84172,237,0,31,0,229.018,237,8172,31,0,16,30,5.88058,25567,5322,30466,0
263,0.959155,51,0,237,0,66.253,51,8191,113,0,54,0,3.9216,25680,5322,30703,0
522,1.90374,111,0,7,0,126.911,111,8191,7,0,152,7,3.41818,25687,5329,30710,0
344,1.25457,69,0,112,0,77.342,69,8191,112,0,88,1,3.95808,25799,5330,30822,0
617,2.25017,104,0,2,0,156.609,140,8189,2,0,232,2,5.60698,25801,5332,30824,0
716,2.61128,116,0,10,0,213.374,178,8191,10,0,189,10,9.79853,25811,5342,30834,0
659,2.40334,147,0,21,0,114.166,189,8189,21,0,66,20,6.44602,25832,5362,30855,0
476,1.73594,3,0,228,0,196.598,3,7999,228,0,16,31,5.42822,26060,5393,31083,0
458,1.67017,86,0,6,0,85.861,86,8191,6,0,130,6,4.91021,26066,5399,31089,0
447,1.63025,120,0,10,0,152.832,120,8190,10,0,107,10,4.63661,26076,5409,31099,0
501,1.82727,139,0,13,0,186.994,139,8163,13,0,81,13,3.33427,26089,5422,31112,0
225,0.820578,42,0,140,0,63.098,42,8187,106,0,42,1,2.76518,26195,5423,31252,0
573,2.0897,103,0,4,0,144.989,109,8082,4,0,158,4,2.75059,26199,5427,31256,0
538,1.9621,142,0,6,0,148.866,142,8185,6,0,128,6,5.11814,26205,5433,31262,0
580,2.11526,160,0,7,0,175.59,160,8096,7,0,89,7,5.11814,26212,5440,31269,0
571,2.08244,169,0,18,0,193.173,169,8176,18,0,46,18,3.96173,26230,5458,31287,0
790,2.88112,115,0,9,0,226.261,208,8189,9,0,228,9,8.82451,26239,5467,31296,0
526,1.91833,212,0,49,0,178.487,212,8173,49,0,27,45,7.87968,26288,5512,31345,0
225,0.820549,3,0,223,0,173.555,3,8189,214,0,8,1,6.63571,26502,5513,31568,0
119,0.434007,11,0,11,0,66.043,2,8189,11,0,56,0,4.76064,26513,5513,31579,0
74,0.269894,5,0,9,0,70.374,5,8189,9,0,38,0,4.49069,26522,5513,31588,0
94,0.34283,11,0,0,0,78.538,11,8189,0,0,49,0,4.07482,26522,5513,31588,0
207,0.754903,18,0,0,0,45.661,18,8189,0,0,106,0,4.69498,26522,5513,31588,0
400,1.45877,27,0,0,0,56.481,27,8191,0,0,204,0,3.39264,26522,5513,31588,0
401,1.46245,33,0,0,0,76.785,33,8189,0,0,204,0,3.18835,26522,5513,31588,0
485,1.76878,81,0,0,0,135.757,81,8189,0,0,225,0,2.86368,26522,5513,31588,0
487,1.77598,72,0,168,0,79.452,2,8190,168,0,127,4,3.0023,26690,5517,31756,0
245,0.893547,19,0,37,0,88.057,19,8189,37,0,102,1,4.47974,26727,5518,31793,0
222,0.809568,24,0,0,0,88.132,24,8189,0,0,115,0,4.54176,26727,5518,31793,0
392,1.42962,31,0,0,0,57.405,31,8189,0,0,198,0,3.96902,26727,5518,31793,0
327,1.19255,36,0,0,0,117.476,36,8191,0,0,166,0,4.51622,26727,5518,31793,0
569,2.07512,104,0,3,0,147.21,104,8189,3,0,209,3,4.44691,26730,5521,31796,0
515,1.87821,138,0,6,0,154.418,138,8127,6,0,128,6,4.65485,26736,5527,31802,0
767,2.79724,149,0,8,0,260.89,188,8191,8,0,254,8,11.1118,26744,5535,31810,0
667,2.43255,143,0,11,0,191.363,211,8189,11,0,142,10,5.58144,26755,5545,31821,0
448,1.63383,216,0,235,0,190.71,2,8176,123,0,33,19,5.07802,26878,5564,32056,0
336,1.22538,77,0,0,0,98.696,77,8191,54,0,108,0,4.61837,26932,5564,32056,0
515,1.87824,123,0,4,0,157.536,126,8189,4,0,154,4,4.70957,26936,5568,32060,0
236,0.860738,142,0,6,0,228.312,142,8110,6,0,68,6,4.47974,26942,5574,32066,0
278,1.01393,56,0,142,0,57.954,56,8189,105,0,63,0,3.07162,27047,5574,32208,0
482,1.7579,110,0,6,0,136.445,110,8191,6,0,139,6,2.86003,27053,5580,32214,0
515,1.87806,126,0,10,0,213.755,126,8191,10,0,60,10,4.00186,27063,5590,32224,0
512,1.86725,152,0,5,0,167.924,152,8191,5,0,114,5,5.2896,27068,5595,32229,0
645,2.3523,175,0,22,0,179.742,175,8177,22,0,117,22,5.2969,27090,5617,32251,0
259,0.944583,37,0,176,0,65.082,37,8189,159,0,35,1,3.53856,27249,5618,32427,0
553,2.01685,105,0,6,0,116.25,109,8189,6,0,165,6,2.49158,27255,5624,32433,0
481,1.75423,131,0,9,0,142.267,131,8190,9,0,81,9,3.44006,27264,5633,32442,0
608,2.21737,161,0,4,0,158.823,165,8189,4,0,161,4,8.14234,27268,5637,32446,0
545,1.98753,174,0,18,0,197.928,174,8191,18,0,46,18,6.21254,27286,5655,32464,0
294,1.07215,42,0,178,0,41.66,42,8189,178,0,41,4,5.14003,27464,5659,32642,0
542,1.97668,121,0,3,0,151.985,121,8189,3,0,202,3,7.83226,27467,5662,32645,0
618,2.25394,181,0,1,0,327.764,181,8187,1,0,285,1,9.12,27468,5663,32646,0
523,1.90744,189,0,10,0,284.269,195,8190,10,0,79,9,14.2783,27478,5672,32656,0
616,2.24677,159,0,6,0,172.614,213,8187,6,0,118,5,17.7913,27484,5677,32662,0
259,0.944663,214,0,22,0,230.699,214,8191,22,0,5,18,35.9912,27506,5695,32684,0
352,1.28378,54,0,214,0,59.785,54,8189,190,0,59,0,22.3112,27696,5695,32898,0
699,2.54931,149,0,3,0,180.306,150,8189,3,0,308,3,6.15418,27699,5698,32901,0
568,2.0716,154,0,10,0,149.492,168,8189,10,0,88,10,9.91162,27709,5708,32911,0
204,0.744041,19,0,172,0,141.768,19,8189,107,0,21,3,19.0243,27816,5711,33083,0
578,2.10808,63,0,3,0,183.857,118,8187,3,0,216,3,4.95398,27819,5714,33086,0
608,2.21737,126,0,11,0,179.299,143,8190,10,0,100,11,3.90701,27829,5725,33097,0
288,1.05039,49,0,146,0,98.673,49,8189,109,0,52,3,4.40314,27938,5728,33243,0
688,2.50899,124,0,3,0,127.791,126,8187,3,0,210,3,5.53402,27941,5731,33246,0
317,1.15607,3,0,143,0,176.766,3,8053,110,0,52,5,5.78208,28051,5736,33389,0
196,0.714809,62,0,1,0,77.701,62,8189,1,0,73,1,4.09306,28052,5737,33390,0
604,2.20286,110,0,5,0,111.866,110,8116,5,0,129,5,4.16237,28057,5742,33395,0
663,2.41796,161,0,6,0,226.083,161,8191,6,0,219,6,8.70778,28063,5748,33401,0
456,1.66303,170,0,19,0,164.665,170,8146,19,0,45,19,8.76979,28082,5767,33420,0
290,1.05766,59,0,170,0,89.118,59,8189,104,0,68,0,4.0201,28186,5767,33590,0
586,2.13731,103,0,4,0,195.941,114,8191,4,0,150,4,3.95078,28190,5771,33594,0
496,1.80902,149,0,9,0,171.944,149,8189,9,0,145,9,5.58144,28199,5780,33603,0
565,2.06063,161,0,14,0,202.811,161,8140,14,0,55,14,5.8368,28213,5794,33617,0
389,1.41868,177,0,10,0,174.773,177,8169,10,0,86,10,7.15008,28223,5804,33627,0
229,0.835161,44,0,177,0,103.998,44,8189,105,0,44,0,6.62112,28328,5804,33804,0
231,0.842343,17,0,71,0,105.955,17,8187,71,0,62,1,5.60698,28399,5805,33875,0
396,1.44422,68,0,0,0,89.306,68,8191,0,0,178,0,4.51258,28399,5805,33875,0
445,1.62286,110,0,6,0,149.074,110,8190,6,0,118,6,4.45786,28405,5811,33881,0
457,1.66609,132,0,7,0,159.792,132,8191,7,0,82,7,4.42138,28412,5818,33888,0
464,1.69227,81,0,133,0,93.441,81,8189,113,0,116,1,4.36301,28525,5819,34021,0
646,2.35607,131,0,8,0,171.913,139,8190,8,0,199,8,4.66214,28533,5827,34029,0
558,2.03504,144,0,8,0,174.814,157,8189,8,0,86,8,7.92346,28541,5835,34037,0


