SendPacket,SendRate(Mb/s),FlightSize,ReceiveRate(Mb/s),Send Loss,Recv Loss,RTT(ms),CWnd,FlowWindow,Retrans,PktSndPeriod(us),RecvACK,RecvNAK,EstimatedBandwidth(Mb/s),Retrans_Total,NAK_TotalRecv,Total Send Loss,Total Recv Loss,Timeout,ExpCount,usSndDuration
276,2.95053,58,0,5,0,133.002,58,8189,5,0,67,5,10.5647,5,5,5,0,0,1,-896020014767518
152,1.7699,68,0,6,0,162.809,68,8191,6,0,20,6,10.3434,11,11,11,0,0,1,1522077144
65,0.75691,4,0,68,0,159.97,4,8189,59,0,2,0,10.0406,70,11,79,0,1,1,4024253394
228,2.65527,35,0,4,0,124.779,35,8191,4,0,88,4,6.76749,74,15,83,0,1,1,2729987064
220,2.56204,37,0,4,0,121.228,37,8190,4,0,65,4,4.9271,78,19,87,0,1,1,2823102996
230,2.67846,48,0,7,0,123.275,48,8190,7,0,57,7,3.24979,85,26,94,0,1,1,2532617178
245,2.85316,56,0,8,0,125.316,56,8191,8,0,56,8,3.41286,93,34,102,0,1,1,2694885158
59,0.68704,3,0,56,0,131.259,3,8135,56,0,1,0,3.41286,149,34,158,0,2,1,2976224748
227,2.64336,29,0,3,0,92.129,29,8191,3,0,79,3,3.33133,152,37,161,0,2,1,3049386816
237,2.75986,32,0,4,0,101.052,32,8189,4,0,77,4,3.37792,156,41,165,0,2,1,2723446390
235,2.73655,34,0,8,0,105.922,34,8164,8,0,59,8,3.50605,164,49,173,0,2,1,2783524924
208,2.42217,35,0,7,0,116.539,35,8191,7,0,64,7,3.86714,171,56,180,0,2,1,2788563990
0,0,35,0,0,0,116.539,35,8191,0,0,0,0,3.86714,171,56,180,0,2,1,0
225,2.62009,21,0,36,0,70.259,21,8191,36,0,91,1,3.86714,207,57,216,0,3,1,5637907268
251,2.92292,25,0,3,0,79,25,8191,3,0,100,3,4.03021,210,60,219,0,3,1,2796451966
188,2.18929,27,0,3,0,88.072,27,8189,3,0,71,3,4.43789,213,63,222,0,3,1,2482060588
171,1.99128,30,0,2,0,98.002,30,8191,2,0,75,2,4.06515,215,65,224,0,3,1,2026462830
72,0.838431,15,0,30,0,65.83,15,8189,30,0,17,0,4.08845,245,65,254,0,4,1,3899408282
244,2.84132,21,0,1,0,71.237,21,8189,1,0,115,1,2.99354,246,66,255,0,4,1,2799388228
207,2.41051,24,0,4,0,96.337,24,8191,4,0,76,4,3.28474,250,70,259,0,4,1,2654671250
228,2.65515,27,0,3,0,90.132,27,8189,3,0,79,3,2.8887,253,73,262,0,4,1,2930400368
257,2.99297,30,0,3,0,94.41,30,8191,3,0,92,3,2.69069,256,76,265,0,4,1,2805940298
114,1.32753,32,0,3,0,105.949,32,8190,3,0,43,3,2.52762,259,79,268,0,4,1,1293398736
76,0.885006,16,0,32,0,80.961,16,8190,32,0,17,0,2.81882,291,79,300,0,5,1,4289426554
202,2.35226,21,0,1,0,67.654,21,8191,1,0,96,1,3.16826,292,80,301,0,5,1,2789759238
251,2.92286,25,0,3,0,83.813,25,8191,3,0,106,3,2.8887,295,83,304,0,5,1,2789895822
214,2.492,28,0,3,0,85.829,28,8191,3,0,72,3,3.87878,298,86,307,0,5,1,2797154948
262,3.05096,31,0,9,0,86.188,31,8191,9,0,84,9,3.99526,307,95,316,0,5,1,2787725416
2,0.0232901,31,0,2,0,86.188,31,8191,2,0,0,2,3.99526,309,97,318,0,5,1,0
243,2.82977,19,0,32,0,58.055,19,8173,32,0,93,1,4.06515,341,98,350,0,6,1,5589854094
163,1.8981,23,0,1,0,114.364,23,8191,1,0,85,1,4.33306,342,99,351,0,6,1,2778814480
239,2.78308,27,0,2,0,84.492,27,8189,2,0,90,2,4.40294,344,101,353,0,6,1,2805382776
218,2.53857,30,0,2,0,142.501,30,8189,2,0,88,2,4.15834,346,103,355,0,6,1,2799612329
238,2.77152,33,0,2,0,124.131,33,8189,2,0,94,2,5.09018,348,105,357,0,6,1,2802399107
229,2.66659,35,0,5,0,108.413,35,8189,5,0,82,5,4.89216,353,110,362,0,6,1,2713851770
248,2.88801,37,0,8,0,103.484,37,8191,8,0,55,8,4.86886,361,118,370,0,6,1,2871640352
238,2.77162,38,0,7,0,107.286,38,8191,7,0,67,7,4.69414,368,125,377,0,6,1,2382773904
289,3.36548,42,0,4,0,121.651,42,8189,4,0,69,4,3.91373,372,129,381,0,6,1,3207133888
248,2.88793,49,0,9,0,139.311,49,8191,9,0,47,9,3.27309,381,138,390,0,6,1,2773165304
31,0.36099,50,0,3,0,147.869,50,8178,3,0,9,3,3.29638,384,141,393,0,6,1,680944334
185,2.15428,26,0,51,0,98.419,26,8189,51,0,59,1,3.06342,435,142,444,0,7,1,4921776804
246,2.86462,29,0,2,0,103.717,29,8162,2,0,90,2,3.2032,437,144,446,0,7,1,2685351634
244,2.84131,32,0,3,0,95.338,32,8189,3,0,95,3,3.69242,440,147,449,0,7,1,2895581626
236,2.74818,34,0,3,0,114.263,34,8189,3,0,75,3,3.92538,443,150,452,0,7,1,2751317758
199,2.31732,36,0,5,0,114.169,36,8190,5,0,67,5,3.66912,448,155,457,0,7,1,2501221856
39,0.454148,3,0,36,0,116.015,3,8155,36,0,1,0,3.68077,484,155,493,0,8,1,3145094806
123,1.43235,20,0,1,0,87.538,20,8190,1,0,57,1,3.55264,485,156,494,0,8,1,2770361754
243,2.82974,24,0,5,0,78.671,24,8189,5,0,95,5,3.45946,490,161,499,0,8,1,2729047000
231,2.68985,27,0,2,0,95.922,27,8189,2,0,83,2,2.90035,492,163,501,0,8,1,2887294774
247,2.87612,31,0,4,0,96.243,31,8191,4,0,99,4,3.02848,496,167,505,0,8,1,2781566956
203,2.36403,33,0,2,0,127.461,33,8186,2,0,86,2,3.21485,498,169,507,0,8,1,2765371392
188,2.18938,35,0,4,0,111.382,35,8191,4,0,46,4,3.35462,502,173,511,0,8,1,2816255344
231,2.68995,37,0,4,0,121.787,37,8191,4,0,99,4,3.45946,506,177,515,0,8,1,2597907704
260,3.02763,40,0,7,0,121.585,40,8189,7,0,80,7,3.8089,513,184,522,0,8,1,2834264692
263,3.06258,47,0,9,0,125.303,47,8191,9,0,65,9,3.93702,522,193,531,0,8,1,2854156074
10,0.116451,47,0,3,0,131.497,47,8184,3,0,1,3,3.94867,525,196,534,0,8,1,494825170
158,1.83989,24,0,47,0,87.645,24,8189,47,0,48,0,3.72736,572,196,581,0,9,1,5126892060
208,2.42214,26,0,4,0,79.441,26,8166,4,0,61,4,3.84384,576,200,585,0,9,1,2806729464
250,2.91139,29,0,4,0,88.495,29,8191,4,0,92,4,3.43616,580,204,589,0,9,1,2799006340
214,2.49196,32,0,4,0,108.166,32,8191,4,0,81,4,3.41286,584,208,593,0,9,1,2689843924
253,2.94632,34,0,4,0,102.561,34,8190,4,0,81,4,3.72736,588,212,597,0,9,1,2964406664
252,2.93453,36,0,5,0,112.698,36,8155,5,0,76,5,3.68077,593,217,602,0,9,1,2653856338
228,2.655,40,0,5,0,133.861,40,8189,5,0,62,5,3.83219,598,222,607,0,9,1,2916398016
240,2.79475,44,0,2,0,143.398,44,8189,2,0,104,2,4.44954,600,224,609,0,9,1,2798714604
278,3.23737,46,0,5,0,139.957,46,8189,5,0,76,5,4.29811,605,229,614,0,9,1,2805536566
204,2.37555,47,0,11,0,177.592,47,8180,11,0,54,11,4.72909,616,240,625,0,9,1,2729378190
0,0,47,0,0,0,177.592,47,8180,0,0,0,0,4.72909,616,240,625,0,9,1,0
205,2.38728,25,0,47,0,113.123,25,8189,47,0,74,0,4.69414,663,240,672,0,10,1,5639577832
255,2.96945,29,0,1,0,88.283,29,8189,1,0,121,1,3.86714,664,241,673,0,10,1,2799899298
224,2.60848,31,0,6,0,108.943,31,8189,6,0,73,6,3.13331,670,247,679,0,10,1,2675297954
244,2.84137,33,0,4,0,104.618,33,8190,4,0,66,4,3.19155,674,251,683,0,10,1,2895461884
223,2.59687,35,0,6,0,113.29,35,8190,6,0,66,6,3.2265,680,257,689,0,10,1,2694545154
247,2.87631,39,0,5,0,131.088,39,8190,5,0,90,5,3.14496,685,262,694,0,10,1,2615694642
270,3.14421,43,0,8,0,136.278,43,8177,8,0,72,8,3.15661,693,270,702,0,10,1,3091072186
87,1.0131,44,0,5,0,119.305,44,8177,5,0,15,5,3.1799,698,275,707,0,10,1,1177409016
138,1.60699,22,0,45,0,80.58,22,8189,45,0,40,1,2.79552,743,276,752,0,11,1,4413886546
228,2.65509,26,0,2,0,94.556,26,8191,2,0,94,2,2.72563,745,278,754,0,11,1,2602315570
216,2.51533,29,0,4,0,85.443,29,8191,4,0,71,4,2.99354,749,282,758,0,11,1,2979346888
208,2.42213,31,0,6,0,92.517,31,8191,6,0,65,6,3.29638,755,288,764,0,11,1,2454182948
204,2.37555,33,0,3,0,120.107,33,8191,3,0,74,3,3.50605,758,291,767,0,11,1,2403745834
249,2.89948,35,0,8,0,112.738,35,8189,8,0,61,8,4.18163,766,299,775,0,11,1,3497603718
180,2.09611,37,0,5,0,111.027,37,8189,5,0,58,5,4.32141,771,304,780,0,11,1,2256296490
258,3.00456,41,0,2,0,131.444,41,8191,2,0,94,2,4.72909,773,306,782,0,11,1,3357015046
229,2.66693,42,0,9,0,119.213,42,8190,9,0,57,9,5.10182,782,315,791,0,11,1,2573290622
264,3.07424,44,0,10,0,126.011,44,8189,10,0,70,10,5.48621,792,325,801,0,11,1,2788239146
238,2.77148,46,0,9,0,130.584,46,8191,9,0,58,9,5.42797,801,334,810,0,11,1,2646055426
243,2.82968,50,0,7,0,119.251,50,8182,7,0,62,7,4.6359,808,341,817,0,11,1,3129280532
21,0.244541,50,0,0,0,125.947,50,8170,0,0,1,0,4.61261,808,341,817,0,11,1,62290116
223,2.5968,26,0,52,0,80.237,26,8189,52,0,65,2,3.86714,860,343,869,0,12,1,5568455046
228,2.655,29,0,4,0,95.913,29,8189,4,0,90,4,3.70406,864,347,873,0,12,1,2792761504
234,2.72491,32,0,2,0,100.809,32,8160,2,0,90,2,3.13331,866,349,875,0,12,1,2709062278
192,2.23581,34,0,5,0,121.278,34,8191,5,0,50,5,3.38957,871,354,880,0,12,1,2883731830
226,2.63173,36,0,6,0,115.457,36,8190,6,0,68,6,3.82054,877,360,886,0,12,1,2608017328
268,3.12102,40,0,5,0,126.601,40,8191,5,0,84,5,4.01856,882,365,891,0,12,1,2985394272
257,2.99275,45,0,9,0,124.855,45,8189,9,0,65,9,4.06515,891,374,900,0,12,1,2734112570
242,2.81799,47,0,8,0,138.019,47,8189,8,0,54,8,3.42451,899,382,908,0,12,1,2775813650
1,0.011645,47,0,1,0,138.019,47,8189,1,0,0,1,3.42451,900,383,909,0,12,1,0
230,2.67834,25,0,49,0,81.934,25,8189,49,0,72,2,3.61088,949,385,958,0,13,1,5652622030
247,2.87633,28,0,4,0,87.492,28,8191,4,0,101,4,3.70406,953,389,962,0,13,1,2606824864
245,2.853,31,0,6,0,111.416,31,8188,6,0,71,6,3.57594,959,395,968,0,13,1,2983290744
153,1.78161,32,0,2,0,118.929,32,8189,2,0,48,2,3.54099,961,397,970,0,13,1,2669611798
164,1.90974,34,0,3,0,133.411,34,8191,3,0,68,3,3.98362,964,400,973,0,13,1,2602543566
158,1.83989,36,0,5,0,104.21,36,8189,5,0,46,5,3.50605,969,405,978,0,13,1,1815858212
42,0.489066,4,0,36,0,109.143,4,8189,36,0,2,0,3.48275,1005,405,1014,0,14,1,3949486086
164,1.90972,21,0,0,0,110.951,21,8189,0,0,77,0,3.54099,1005,405,1014,0,14,1,2900057888
244,2.84129,25,0,4,0,81.714,25,8189,4,0,100,4,3.07507,1009,409,1018,0,14,1,2822502648
206,2.39882,28,0,5,0,86.116,28,8190,5,0,68,5,3.2265,1014,414,1023,0,14,1,2704038610
257,2.99271,31,0,2,0,115.74,31,8191,2,0,92,2,3.30803,1016,416,1025,0,14,1,2899597722
241,2.80636,33,0,6,0,101.249,33,8190,6,0,82,6,3.19155,1022,422,1031,0,14,1,2793219748
253,2.94616,36,0,6,0,114.618,36,8189,6,0,81,6,2.99354,1028,428,1037,0,14,1,2793435746
134,1.56037,37,0,4,0,123.356,37,8190,4,0,51,4,2.97024,1032,432,1041,0,14,1,1475810630
51,0.593929,7,0,37,0,122.8,7,8189,37,0,5,0,2.98189,1069,432,1078,0,15,1,4078617564
185,2.15444,21,0,2,0,73.364,21,8191,2,0,81,2,3.09837,1071,434,1080,0,15,1,2161619516
222,2.5855,25,0,0,0,98.834,25,8191,0,0,105,0,3.2032,1071,434,1080,0,15,1,3463589346
271,3.15593,30,0,1,0,91.697,30,8191,1,0,125,1,3.83219,1072,435,1081,0,15,1,2779903350
240,2.79479,32,0,5,0,96.495,32,8189,5,0,78,5,4.08845,1077,440,1086,0,15,1,2786410928
235,2.73652,35,0,5,0,112.022,35,8191,5,0,73,5,3.7856,1082,445,1091,0,15,1,2784181526
213,2.48035,36,0,6,0,105.074,36,8190,6,0,71,6,4.40294,1088,451,1097,0,15,1,2611412944
230,2.67837,38,0,6,0,108.003,38,8191,6,0,55,6,3.31968,1094,457,1103,0,15,1,3001128494
234,2.72491,40,0,6,0,121.854,40,8190,6,0,55,6,2.79552,1100,463,1109,0,15,1,2702997010
262,3.05095,48,0,6,0,133.968,48,8189,6,0,69,6,3.68077,1106,469,1115,0,15,1,2835015806
226,2.63169,61,0,8,0,128.907,61,8189,8,0,60,8,5.03194,1114,477,1123,0,15,1,2390677996
295,3.4352,63,0,11,0,232.287,78,8187,11,0,53,11,4.90381,1125,488,1134,0,15,1,3228640058
67,0.780195,82,0,7,0,231.453,82,8179,7,0,11,7,5.11347,1132,495,1141,0,15,1,1076455380
97,1.12955,15,0,82,0,148.128,15,8189,60,0,13,0,5.5328,1192,495,1223,0,16,1,4325392512
265,3.08588,59,0,8,0,151.772,59,8189,8,0,88,8,4.88051,1200,503,1231,0,16,1,2577349292
20,0.232884,59,0,0,0,152.756,59,8171,0,0,1,0,4.86886,1200,503,1231,0,16,1,493648456
226,2.6318,30,0,61,0,84.104,30,8189,61,0,61,2,4.16998,1261,505,1292,0,17,1,5209271130
192,2.23581,31,0,4,0,99.992,31,8176,4,0,54,4,4.37965,1265,509,1296,0,17,1,2444930236
238,2.77146,34,0,4,0,113.106,34,8189,4,0,75,4,3.93702,1269,513,1300,0,17,1,3449899348
247,2.87627,36,0,3,0,119.296,36,8189,3,0,95,3,4.12339,1272,516,1303,0,17,1,2793282800
248,2.88794,43,0,8,0,135.383,43,8189,8,0,69,8,4.01856,1280,524,1311,0,17,1,2798721548
243,2.8297,50,0,9,0,149.581,50,8191,9,0,56,9,4.18163,1289,533,1320,0,17,1,2650987444
220,2.56182,54,0,6,0,165.253,54,8189,6,0,59,6,4.06515,1295,539,1326,0,17,1,2524950372
197,2.29403,55,0,7,0,161.764,55,8175,7,0,39,7,3.98362,1302,546,1333,0,17,1,2452917502
58,0.675398,3,0,55,0,162.753,3,8136,55,0,1,0,3.96032,1357,546,1388,0,18,1,3014054344
186,2.16605,28,0,1,0,118.879,28,8189,1,0,74,1,4.61261,1358,547,1389,0,18,1,3331487606
230,2.67835,31,0,2,0,114.857,31,8191,2,0,90,2,3.94867,1360,549,1391,0,18,1,2686355498
208,2.42198,33,0,5,0,104.58,33,8191,5,0,60,5,3.70406,1365,554,1396,0,18,1,2284232216
251,2.92285,35,0,4,0,111.159,35,8189,4,0,63,4,3.90208,1369,558,1400,0,18,1,3405382680
223,2.59679,37,0,7,0,108.601,37,8190,7,0,79,7,3.64582,1376,565,1407,0,18,1,2425641134
294,3.42354,46,0,7,0,133.973,46,8189,7,0,71,7,3.19155,1383,572,1414,0,18,1,3154969580
239,2.78327,50,0,13,0,144.403,50,8190,13,0,73,13,2.912,1396,585,1427,0,18,1,2536244032
199,2.31736,52,0,10,0,159.866,52,8191,10,0,41,10,2.8887,1406,595,1437,0,18,1,2457328370
55,0.640478,3,0,52,0,158.571,3,8139,52,0,1,0,2.84211,1458,595,1489,0,19,1,3025001196
242,2.81785,28,0,2,0,95.392,28,8191,2,0,100,2,2.56256,1460,597,1491,0,19,1,3127103546
254,2.95796,31,0,8,0,84.008,31,8191,8,0,83,8,2.8887,1468,605,1499,0,19,1,2840677196
255,2.96944,34,0,6,0,99.203,34,8191,6,0,84,6,2.94694,1474,611,1505,0,19,1,2771228880
222,2.58517,35,0,7,0,99.832,35,8189,7,0,64,7,3.02848,1481,618,1512,0,19,1,2544246544
251,2.92287,37,0,5,0,101.629,37,8191,5,0,57,5,3.38957,1486,623,1517,0,19,1,2975170758
265,3.08582,44,0,5,0,124.064,44,8189,5,0,76,5,3.65747,1491,628,1522,0,19,1,2778053992
111,1.29257,46,0,6,0,136.265,46,8168,6,0,23,6,3.86714,1497,634,1528,0,19,1,1442556192
135,1.57206,23,0,46,0,70.327,23,8189,46,0,37,0,4.0768,1543,634,1574,0,20,1,4246697434
205,2.38721,26,0,6,0,79.328,26,8189,6,0,80,6,4.20493,1549,640,1580,0,20,1,2557798586
234,2.72489,30,0,2,0,99.45,30,8190,2,0,95,2,3.5177,1551,642,1582,0,20,1,2799920116
304,3.54006,34,0,3,0,105.223,34,8189,3,0,125,3,3.50605,1554,645,1585,0,20,1,2913983742
236,2.74822,35,0,8,0,104.619,35,8189,8,0,67,8,2.94694,1562,653,1593,0,20,1,2860768436
70,0.815129,36,0,2,0,105.598,36,8190,2,0,20,2,2.86541,1564,655,1595,0,20,1,772518524
119,1.38579,19,0,36,0,82.982,19,8189,36,0,36,0,2.74893,1600,655,1631,0,21,1,4848310208
163,1.89812,23,0,1,0,101.78,23,8189,1,0,85,1,2.5975,1601,656,1632,0,21,1,2396785272
232,2.70176,27,0,2,0,80.76,27,8189,2,0,99,2,2.51597,1603,658,1634,0,21,1,3194886028
246,2.86466,30,0,4,0,107.475,30,8189,4,0,88,4,2.72563,1607,662,1638,0,21,1,2795980154
218,2.53851,32,0,4,0,97.691,32,8191,4,0,67,4,2.71398,1611,666,1642,0,21,1,2583030562
240,2.79479,34,0,5,0,116.601,34,8181,5,0,60,5,2.90035,1616,671,1647,0,21,1,2988292090
199,2.31732,35,0,4,0,119.532,35,8190,4,0,55,4,2.94694,1620,675,1651,0,21,1,2798691308
236,2.74815,37,0,2,0,131.323,37,8189,2,0,85,2,3.56429,1622,677,1653,0,21,1,2707394681
222,2.58518,40,0,6,0,148.067,40,8189,6,0,73,6,3.26144,1628,683,1659,0,21,1,2689466453
271,3.15577,45,0,7,0,136.637,45,8146,7,0,53,7,3.45946,1635,690,1666,0,21,1,3006388630
147,1.71175,51,0,4,0,153.94,51,8169,4,0,38,4,3.68077,1639,694,1670,0,21,1,2325687582
54,0.628818,3,0,51,0,153.422,3,8140,51,0,1,0,3.72736,1690,694,1721,0,22,1,2953160342
204,2.37554,27,0,2,0,101.648,27,8189,2,0,82,2,3.48275,1692,696,1723,0,22,1,3027642688
252,2.93431,30,0,2,0,95.144,30,8189,2,0,103,2,3.62253,1694,698,1725,0,22,1,2864040582
246,2.86484,33,0,3,0,116.039,33,8189,3,0,98,3,3.86714,1697,701,1728,0,22,1,2795868148
244,2.84159,36,0,8,0,101.961,36,8189,8,0,76,8,3.96032,1705,709,1736,0,22,1,2654425998
253,2.94595,37,0,8,0,110.193,37,8190,8,0,49,8,3.86714,1713,717,1744,0,22,1,2778794606
260,3.02763,42,0,5,0,121.895,42,8191,5,0,62,5,4.33306,1718,722,1749,0,22,1,2899395002
243,2.82968,46,0,7,0,137.564,46,8177,7,0,57,7,4.14669,1725,729,1756,0,22,1,2733104934
37,0.430857,47,0,3,0,134.171,47,8189,3,0,17,3,4.00691,1728,732,1759,0,22,1,308576058
171,1.99139,24,0,48,0,79.055,24,8191,48,0,52,1,3.91373,1776,733,1807,0,23,1,5398065316
238,2.77151,28,0,4,0,117.808,28,8191,4,0,111,4,4.33306,1780,737,1811,0,23,1,2607317132
89,1.0364,29,0,2,0,100.482,29,8189,2,0,31,2,4.35635,1782,739,1813,0,23,1,1039321346
110,1.2809,15,0,29,0,70.73,15,8189,29,0,40,0,4.33306,1811,739,1842,0,24,1,4684839726
140,1.63029,19,0,2,0,123.364,19,8189,2,0,61,2,4.04186,1813,741,1844,0,24,1,2831428362
180,2.09614,23,0,0,0,113.438,23,8191,0,0,92,0,4.04186,1813,741,1844,0,24,1,2762684022
247,2.87633,27,0,2,0,89.972,27,8189,2,0,103,2,4.6825,1815,743,1846,0,24,1,2744488124
217,2.52684,30,0,4,0,122.828,30,8190,4,0,86,4,4.84557,1819,747,1850,0,24,1,2665878698
256,2.98125,32,0,5,0,111.861,32,8187,5,0,73,5,4.91546,1824,752,1855,0,24,1,3011446942
259,3.01598,35,0,5,0,107.61,35,8191,5,0,85,5,4.99699,1829,757,1860,0,24,1,2794165570
25,0.29114,35,0,2,0,117.556,35,8189,2,0,13,2,5.07853,1831,759,1862,0,24,1,287369250
142,1.65363,18,0,36,0,71.642,18,8190,36,0,49,1,5.5328,1867,760,1898,0,25,1,5302086720
209,2.43378,22,0,3,0,71.137,22,8190,3,0,84,3,4.368,1870,763,1901,0,25,1,2666085560
212,2.46876,26,0,3,0,106.745,26,8191,3,0,76,3,3.62253,1873,766,1904,0,25,1,2829149486
238,2.77139,29,0,2,0,88.769,29,8191,2,0,95,2,3.50605,1875,768,1906,0,25,1,2731774108
205,2.38711,31,0,4,0,97.474,31,8190,4,0,66,4,3.29638,1879,772,1910,0,25,1,2712326386
239,2.78313,33,0,6,0,110.483,33,8190,6,0,77,6,2.79552,1885,778,1916,0,25,1,2970066274
271,3.15577,36,0,5,0,112.828,36,8189,5,0,74,5,3.15661,1890,783,1921,0,25,1,2856576394
215,2.50376,37,0,6,0,118.605,37,8191,6,0,59,6,3.1799,1896,789,1927,0,25,1,2707772774
0,0,37,0,0,0,118.605,37,8191,0,0,0,0,3.1799,1896,789,1927,0,25,1,0
222,2.58512,21,0,38,0,75.371,21,8191,38,0,79,1,3.05178,1934,790,1965,0,26,1,5547194702
217,2.52699,25,0,3,0,88.648,25,8189,3,0,91,3,3.38957,1937,793,1968,0,26,1,2889574674
266,3.09732,29,0,2,0,91.286,29,8189,2,0,110,2,3.12166,1939,795,1970,0,26,1,2809270632
195,2.27078,31,0,4,0,93.876,31,8189,4,0,58,4,3.34298,1943,799,1974,0,26,1,2772786506
223,2.59657,33,0,7,0,96.314,33,8191,7,0,85,7,3.64582,1950,806,1981,0,26,1,2458834396
249,2.89977,35,0,7,0,131.554,35,8191,7,0,65,7,3.62253,1957,813,1988,0,26,1,3152220060
232,2.70157,37,0,2,0,123.137,37,8189,2,0,84,2,4.14669,1959,815,1990,0,26,1,2802285738
256,2.98107,40,0,8,0,123.389,40,8189,8,0,76,8,4.82227,1967,823,1998,0,26,1,2634534420
253,2.94614,47,0,4,0,144.687,47,8190,4,0,63,4,4.48448,1971,827,2002,0,26,1,2910630492
230,2.67817,57,0,9,0,161.491,57,8183,9,0,50,9,4.14669,1980,836,2011,0,26,1,2688579320
60,0.698689,3,0,57,0,161.919,3,8134,57,0,1,0,4.13504,2037,836,2068,0,27,1,2944747064
173,2.01457,28,0,3,0,94.993,28,8189,3,0,50,3,4.0535,2040,839,2071,0,27,1,2741276426
238,2.77144,31,0,4,0,97.978,31,8191,4,0,66,4,3.77395,2044,843,2075,0,27,1,2673095658
195,2.27073,33,0,3,0,107.85,33,8189,3,0,69,3,3.86714,2047,846,2078,0,27,1,2226188816
43,0.500727,6,0,33,0,103.212,6,8189,33,0,4,0,3.86714,2080,846,2111,0,28,1,3466912316
251,2.92286,22,0,0,0,72.27,22,8191,0,0,125,0,4.47283,2080,846,2111,0,28,1,2861938086
229,2.66674,26,0,0,0,95.842,26,8189,0,0,115,0,4.12339,2080,846,2111,0,28,1,2783199716
249,2.89968,30,0,1,0,100.471,30,8189,1,0,113,1,4.48448,2081,847,2112,0,28,1,2738164524
205,2.38709,32,0,3,0,105.989,32,8189,3,0,62,3,4.76403,2084,850,2115,0,28,1,2839277378
268,3.12101,35,0,4,0,110.283,35,8191,4,0,92,4,4.1001,2088,854,2119,0,28,1,2806134464
239,2.78334,37,0,5,0,122.19,37,8189,5,0,70,5,3.82054,2093,859,2124,0,28,1,2813052144
230,2.67843,39,0,9,0,120.919,39,8190,9,0,81,9,3.38957,2102,868,2133,0,28,1,2598373722
111,1.29257,41,0,3,0,107.278,41,8190,3,0,31,3,3.52934,2105,871,2136,0,28,1,1306279884
148,1.7234,21,0,41,0,67.876,21,8189,41,0,46,0,3.41286,2146,871,2177,0,29,1,4453538712
197,2.29402,25,0,1,0,117.499,25,8191,1,0,92,1,3.56429,2147,872,2178,0,29,1,2802378194
240,2.79476,28,0,5,0,84.024,28,8189,5,0,87,5,3.55264,2152,877,2183,0,29,1,2800743064
224,2.60842,31,0,7,0,90.77,31,8191,7,0,76,7,3.72736,2159,884,2190,0,29,1,2680075230
237,2.75992,33,0,5,0,100.243,33,8189,5,0,77,5,4.13504,2164,889,2195,0,29,1,2910250658
221,2.57352,34,0,8,0,91.912,34,8191,8,0,51,8,3.93702,2172,897,2203,0,29,1,2729356378
181,2.1078,36,0,4,0,123.669,36,8189,4,0,57,4,3.08672,2176,901,2207,0,29,1,1977359552
233,2.71325,38,0,5,0,120.613,38,8191,5,0,64,5,2.94694,2181,906,2212,0,29,1,3441819724
12,0.139737,38,0,1,0,122.355,38,8191,1,0,1,1,2.94694,2182,907,2213,0,29,1,369063758
154,1.79329,20,0,38,0,81.85,20,8189,38,0,55,0,2.912,2220,907,2251,0,30,1,5398543780
183,2.13107,24,0,1,0,140.292,24,8191,1,0,87,1,2.52762,2221,908,2252,0,30,1,2843860869
230,2.67845,28,0,2,0,130.193,28,8190,2,0,94,2,2.36454,2223,910,2254,0,30,1,2794965765
231,2.68993,30,0,3,0,88.855,30,8189,3,0,76,3,3.62253,2226,913,2257,0,30,1,2679541004
224,2.60855,33,0,5,0,108.863,33,8189,5,0,72,5,4.06515,2231,918,2262,0,30,1,2906377446
233,2.71326,35,0,6,0,96.067,35,8189,6,0,69,6,4.6825,2237,924,2268,0,30,1,2631980666
250,2.91121,37,0,8,0,113.709,37,8189,8,0,77,8,4.84557,2245,932,2276,0,30,1,2897604290
255,2.96943,38,0,11,0,105.913,38,8178,11,0,41,11,4.53107,2256,943,2287,0,30,1,2786725592
239,2.78313,40,0,6,0,126.879,40,8190,6,0,66,6,4.04186,2262,949,2293,0,30,1,2870012880
237,2.75984,47,0,9,0,125.965,47,8189,9,0,57,9,3.7623,2271,958,2302,0,30,1,2797135292
220,2.56194,57,0,9,0,144.102,57,8191,9,0,55,9,3.82054,2280,967,2311,0,30,1,2271185522
257,2.99259,69,0,11,0,174.608,69,8179,11,0,44,11,3.36627,2291,978,2322,0,30,1,2824612066
0,0,69,0,0,0,174.608,69,8179,0,0,0,0,3.36627,2291,978,2322,0,30,1,0
197,2.29411,34,0,70,0,129.154,34,8191,60,0,57,1,4.20493,2351,979,2392,0,31,1,5843431272
258,3.0044,36,0,5,0,106.454,36,8161,5,0,64,5,4.67085,2356,984,2397,0,31,1,2925236574
259,3.01602,43,0,6,0,113.597,43,8189,6,0,71,6,3.99526,2362,990,2403,0,31,1,2855924420
200,2.32897,53,0,8,0,143.33,53,8189,8,0,50,8,3.43616,2370,998,2411,0,31,1,2325279474
293,3.41204,59,0,9,0,173.428,59,8157,9,0,50,9,3.21485,2379,1007,2420,0,31,1,3285657956
303,3.52859,63,0,11,0,115.413,63,8187,11,0,67,11,3.24979,2390,1018,2431,0,31,1,2506083244
267,3.10921,61,0,15,0,185.24,65,8186,15,0,45,15,2.87706,2405,1033,2446,0,31,1,2930070738
7,0.0815138,65,0,3,0,185.24,65,8186,3,0,0,3,2.87706,2408,1036,2449,0,31,1,0
213,2.48045,32,0,68,0,92.931,32,8189,62,0,51,3,3.26144,2470,1039,2517,0,32,1,5723714010
233,2.71326,35,0,5,0,108.476,35,8191,5,0,87,5,3.14496,2475,1044,2522,0,32,1,2830176734
247,2.87636,37,0,9,0,114.231,37,8189,9,0,77,9,3.1799,2484,1053,2531,0,32,1,2779029610
206,2.39886,44,0,6,0,116.221,44,8149,6,0,46,6,3.64582,2490,1059,2537,0,32,1,2333200940
277,3.22563,54,0,6,0,156.123,54,8170,6,0,64,6,3.7623,2496,1065,2543,0,32,1,3153495436
186,2.16599,57,0,11,0,175.44,57,8191,11,0,37,11,3.99526,2507,1076,2554,0,32,1,2058088046
60,0.698624,3,0,57,0,174.652,3,8134,57,0,1,0,4.01856,2564,1076,2611,0,33,1,3567127508
212,2.46868,29,0,3,0,88.496,29,8189,3,0,82,3,3.5177,2567,1079,2614,0,33,1,2836151934
247,2.87624,32,0,10,0,100.067,32,8189,10,0,82,10,3.26144,2577,1089,2624,0,33,1,2832612108
223,2.59682,34,0,8,0,101.496,34,8189,8,0,67,8,3.27309,2585,1097,2632,0,33,1,2743407012
175,2.03794,35,0,5,0,108.955,35,8189,5,0,40,5,3.2032,2590,1102,2637,0,33,1,2583132370
177,2.06083,36,0,4,0,123.528,36,8176,4,0,38,4,3.33133,2594,1106,2641,0,33,1,2624923546
209,2.43405,39,0,5,0,115.599,39,8191,5,0,52,5,3.27309,2599,1111,2646,0,33,1,3015483842
241,2.80657,47,0,5,0,118.141,47,8189,5,0,57,5,3.75066,2604,1116,2651,0,33,1,2715459026
235,2.73653,51,0,5,0,151.305,51,8189,5,0,48,5,3.66912,2609,1121,2656,0,33,1,3076541300
253,2.94619,53,0,8,0,157.615,53,8191,8,0,52,8,4.29811,2617,1129,2664,0,33,1,2657723390
271,3.15582,55,0,11,0,154.999,55,8191,11,0,61,11,4.27482,2628,1140,2675,0,33,1,2725913764
199,2.31732,55,0,10,0,168.028,55,8191,10,0,40,10,4.0535,2638,1150,2685,0,33,1,2596080578
58,0.675373,3,0,55,0,168.909,3,8136,55,0,1,0,4.01856,2693,1150,2740,0,34,1,3114499570
209,2.43372,28,0,3,0,90.767,28,8189,3,0,70,3,3.44781,2696,1153,2743,0,34,1,2875464592
204,2.37554,31,0,3,0,106.08,31,8189,3,0,76,3,3.29638,2699,1156,2746,0,34,1,2792008240
242,2.81804,33,0,7,0,101.44,33,8190,7,0,73,7,3.45946,2706,1163,2753,0,34,1,2792638688
248,2.88798,35,0,8,0,102.869,35,8189,8,0,78,8,3.99526,2714,1171,2761,0,34,1,2797989446
16,0.186318,35,0,2,0,101.602,35,8189,2,0,7,2,4.04186,2716,1173,2763,0,34,1,176149092
156,1.81661,19,0,35,0,94.478,19,8191,35,0,57,0,4.20493,2751,1173,2798,0,35,1,5389477272
203,2.36377,23,0,1,0,91.674,23,8191,1,0,93,1,4.46118,2752,1174,2799,0,35,1,2801657218
208,2.42224,26,0,4,0,82.356,26,8191,4,0,70,4,4.48448,2756,1178,2803,0,35,1,2735100158
207,2.41061,28,0,5,0,90.336,28,8189,5,0,68,5,4.26317,2761,1183,2808,0,35,1,2875428052
219,2.55031,31,0,5,0,101.674,31,8189,5,0,83,5,4.11174,2766,1188,2813,0,35,1,2789329970
240,2.79477,34,0,4,0,137.915,34,8191,4,0,106,4,4.12339,2770,1192,2817,0,35,1,2456840482
251,2.92283,36,0,8,0,105.438,36,8176,8,0,71,8,3.99526,2778,1200,2825,0,35,1,3085349864
256,2.98105,39,0,5,0,128.496,39,8190,5,0,84,5,3.61088,2783,1205,2830,0,35,1,2729088768
236,2.74818,41,0,10,0,128.19,41,8189,10,0,45,10,3.30803,2793,1215,2840,0,35,1,2844410688
270,3.14423,50,0,5,0,124.367,50,8191,5,0,69,5,3.24979,2798,1220,2845,0,35,1,2802626890
278,3.23707,67,0,7,0,173.195,67,8191,7,0,76,7,2.95859,2805,1227,2852,0,35,1,2844747178
315,3.66812,87,0,16,0,197.782,87,8191,16,0,50,16,3.27309,2821,1243,2868,0,35,1,2700519598
7,0.0815144,87,0,7,0,197.782,87,8191,7,0,0,7,3.27309,2828,1250,2875,0,35,1,0
182,2.1194,37,0,87,0,90.129,37,8191,85,0,35,0,3.64582,2913,1250,2962,0,36,1,5683618010
227,2.64337,59,0,14,0,144.672,59,8191,14,0,56,14,3.75066,2927,1264,2976,0,36,1,2171391502
21,0.244539,59,0,0,0,158.772,59,8191,0,0,2,0,3.72736,2927,1264,2976,0,36,1,648858490
244,2.84141,29,0,61,0,89.926,29,8162,61,0,55,2,4.11174,2988,1266,3037,0,37,1,5516617120
248,2.88817,33,0,4,0,100.246,33,8191,4,0,99,4,4.26317,2992,1270,3041,0,37,1,2775117534
250,2.91137,35,0,5,0,112.179,35,8191,5,0,83,5,3.44781,2997,1275,3046,0,37,1,2845412486
212,2.46887,37,0,6,0,137.843,37,8186,6,0,74,6,3.7623,3003,1281,3052,0,37,1,2522136092
274,3.1907,46,0,5,0,136.142,46,8191,5,0,59,5,3.31968,3008,1286,3057,0,37,1,3057379094
245,2.85308,51,0,7,0,153.469,51,8191,7,0,53,7,2.92365,3015,1293,3064,0,37,1,2802238866
110,1.28094,53,0,8,0,166.823,53,8189,8,0,28,8,2.86541,3023,1301,3072,0,37,1,1359458828
56,0.652103,3,0,53,0,173.559,3,8138,53,0,1,0,2.87706,3076,1301,3125,0,38,1,3672068148
238,2.77146,27,0,6,0,95.678,27,8191,6,0,75,6,3.31968,3082,1307,3131,0,38,1,3299656766


