SendPacket,SendRate(Mb/s),FlightSize,ReceiveRate(Mb/s),Send Loss,Recv Loss,RTT(ms),CWnd,FlowWindow,Retrans,PktSndPeriod(us),RecvACK,RecvNAK,EstimatedBandwidth(Mb/s),Retrans_Total,NAK_TotalRecv,Total Send Loss,Total Recv Loss
486,2.55496,90,0,5,0,85.109,90,8189,5,0,140,5,4.81774,5,5,5,0
396,2.23587,11,0,111,0,101.054,11,8191,85,0,48,8,4.45627,90,13,116,0
483,2.72742,60,0,5,0,113.818,75,8189,5,0,128,5,4.79515,95,18,121,0
506,2.85705,63,0,9,0,105.354,87,8191,9,0,91,9,6.54038,104,27,130,0
550,3.10521,40,0,6,0,147.083,96,8191,6,0,171,6,6.96398,110,33,136,0
637,3.59631,57,0,5,0,134.707,100,8189,5,0,174,5,6.32011,115,38,141,0
582,3.28629,65,0,27,0,85.782,101,8169,27,0,57,27,8.4833,142,65,168,0
547,3.08863,101,0,20,0,100.504,101,8174,20,0,56,20,7.74341,162,85,188,0
505,2.85147,102,0,13,0,140.154,102,8189,13,0,113,13,7.15602,175,98,201,0
613,3.46136,81,0,5,0,122.411,103,8189,5,0,119,5,6.2128,180,103,206,0
549,3.10006,105,0,22,0,104.771,105,8183,22,0,75,22,5.73272,202,125,228,0
382,2.15693,69,0,114,0,71.873,69,8189,67,0,107,9,6.30882,269,134,342,0
525,2.96439,67,0,13,0,126.885,88,8191,13,0,122,13,6.0829,282,147,355,0
562,3.17345,94,0,14,0,112.759,95,8189,14,0,103,14,4.77821,296,161,369,0
550,3.10556,98,0,11,0,122.738,98,8191,11,0,90,11,5.77226,307,172,380,0
465,2.62559,64,0,99,0,92.306,76,8191,59,0,156,0,6.65899,366,172,479,0
559,3.15639,88,0,15,0,92.499,88,8179,15,0,128,15,7.00352,381,187,494,0
573,3.23538,94,0,5,0,160.897,94,8189,5,0,165,5,6.96398,386,192,499,0
616,3.47829,65,0,11,0,85.512,96,8191,11,0,108,11,6.7663,397,203,510,0
541,3.05498,84,0,16,0,109.387,97,8191,16,0,102,16,5.52939,413,219,526,0
397,2.24182,97,0,122,0,111.302,2,8191,83,0,25,24,5.86827,496,243,648,0
342,1.93111,68,0,5,0,76.001,68,8190,6,0,114,5,7.28027,502,248,653,0
559,3.15639,84,0,5,0,118.153,84,8189,5,0,129,5,7.08824,507,253,658,0
449,2.53526,3,0,95,0,105.887,3,8102,64,0,85,6,6.82843,571,259,753,0
442,2.49574,15,0,70,0,83.431,3,8139,70,0,131,4,6.7663,641,263,823,0
500,2.82325,46,0,0,0,62.885,46,8191,0,0,235,0,6.17891,641,263,823,0
481,2.71596,58,0,5,0,91.759,61,8155,5,0,155,5,5.46726,646,268,828,0
522,2.94747,65,0,7,0,129.459,65,8191,7,0,136,7,4.49581,653,275,835,0
498,2.81181,54,0,3,0,85.579,68,8189,3,0,195,3,4.40544,656,278,838,0
520,2.93614,76,0,6,0,113.016,76,8190,6,0,153,6,5.20181,662,284,844,0
452,2.55231,96,0,6,0,126.559,96,8190,6,0,138,6,6.65334,668,290,850,0
433,2.44492,67,0,97,0,101.409,71,8189,60,0,134,1,6.46131,728,291,947,0
515,2.90793,84,0,4,0,120.634,85,8189,4,0,138,4,5.20746,732,295,951,0
500,2.82319,90,0,12,0,94.447,90,8189,12,0,100,12,5.83438,744,307,963,0
578,3.26375,93,0,8,0,120.592,93,8191,8,0,146,8,5.41078,752,315,971,0
586,3.30904,63,0,16,0,74.013,94,8189,16,0,85,16,4.97024,768,331,987,0
564,3.18461,95,0,16,0,97.54,95,8191,16,0,63,16,4.9307,784,347,1003,0
488,2.7555,95,0,27,0,101.915,95,8191,27,0,42,27,5.13968,811,374,1030,0
349,1.97063,33,0,108,0,60.277,33,8191,71,0,54,13,5.58022,882,387,1138,0
545,3.0774,57,0,6,0,95.082,78,8189,6,0,161,6,5.54069,888,393,1144,0
543,3.06608,71,0,4,0,110.987,88,8191,4,0,150,4,6.04336,892,397,1148,0
356,2.01012,14,0,95,0,105.372,14,8189,64,0,92,5,6.20715,956,402,1243,0
478,2.69907,33,0,70,0,50.252,33,8190,67,0,140,5,5.63106,1023,407,1313,0
360,2.03269,22,0,34,0,41.637,22,8189,34,0,159,1,5.06626,1057,408,1347,0
510,2.8799,31,0,0,0,51.398,31,8189,0,0,257,0,5.81179,1057,408,1347,0
508,2.86844,39,0,0,0,77.647,39,8189,0,0,258,0,8.77699,1057,408,1347,0
521,2.94185,67,0,4,0,79.222,67,8189,4,0,183,4,8.72616,1061,412,1351,0
558,3.1507,79,0,6,0,110.949,115,8189,6,0,139,6,6.44437,1067,418,1357,0
590,3.33131,105,0,26,0,97.888,122,8169,26,0,28,26,6.15632,1093,444,1383,0
300,1.69405,30,0,142,0,79.543,30,8191,109,0,35,16,6.61946,1202,460,1525,0
557,3.1453,86,0,6,0,126.648,90,8189,6,0,140,6,5.54634,1208,466,1531,0
367,2.07233,4,0,106,0,125.715,4,8190,65,0,63,7,4.51275,1273,473,1637,0
492,2.77828,70,0,6,0,107.335,75,8189,6,0,150,6,5.27523,1279,479,1643,0
517,2.91925,87,0,10,0,105.683,87,8190,10,0,110,10,5.94734,1289,489,1653,0
494,2.78933,90,0,10,0,104.512,90,8191,10,0,67,10,4.92506,1299,499,1663,0
512,2.891,94,0,8,0,132.643,94,8190,8,0,125,8,5.42208,1307,507,1671,0
555,3.13369,69,0,8,0,110.929,96,8189,8,0,95,8,5.11144,1315,515,1679,0
507,2.86298,65,0,6,0,151.178,97,8189,6,0,137,6,6.2128,1321,521,1685,0
572,3.22983,98,0,28,0,75.055,98,8191,28,0,86,28,6.52344,1349,549,1713,0
633,3.57424,61,0,12,0,104.401,99,8140,12,0,107,12,5.68189,1361,561,1725,0
529,2.98697,62,0,12,0,91.337,101,8191,12,0,98,12,5.42208,1373,573,1737,0
435,2.45621,70,0,102,0,98.492,70,8189,101,0,130,8,4.68219,1474,581,1839,0
324,1.82946,36,0,72,0,61.075,36,8190,72,0,97,2,5.0832,1546,583,1911,0
459,2.59173,59,0,3,0,84.142,59,8189,3,0,163,3,4.79515,1549,586,1914,0
550,3.10549,63,0,6,0,94.927,67,8182,6,0,183,6,5.64235,1555,592,1920,0
509,2.87398,68,0,5,0,112.843,69,8189,5,0,141,5,6.91315,1560,597,1925,0
398,2.24747,36,0,73,0,62.818,36,8191,62,0,124,3,4.73302,1622,600,1998,0
519,2.93066,62,0,3,0,95.545,62,8191,3,0,224,3,4.67654,1625,603,2001,0
466,2.63124,35,0,62,0,69.214,35,8189,62,0,190,1,6.73242,1687,604,2063,0
411,2.32069,20,0,51,0,72.795,20,8191,51,0,153,2,6.56298,1738,606,2114,0
413,2.33205,31,0,0,0,69.024,31,8189,0,0,207,0,5.74966,1738,606,2114,0
541,3.05436,42,0,0,0,62.781,42,8187,0,0,272,0,6.46696,1738,606,2114,0
499,2.81777,48,0,3,0,84.975,48,8157,3,0,189,3,6.2128,1741,609,2117,0
360,2.03242,27,0,50,0,44.235,27,8189,50,0,149,1,5.00978,1791,610,2167,0
442,2.49521,33,0,2,0,64.81,33,8189,2,0,197,2,4.02138,1793,612,2169,0
496,2.80068,45,0,0,0,65.773,45,8189,0,0,249,0,6.0603,1793,612,2169,0
491,2.7721,49,0,5,0,73.337,49,8190,5,0,182,5,7.33675,1798,617,2174,0
314,1.77312,28,0,49,0,63.23,28,8191,49,0,128,0,6.34835,1847,617,2223,0
475,2.68174,35,0,1,0,62.672,35,8191,1,0,239,1,4.81774,1848,618,2224,0
488,2.75564,46,0,1,0,75.829,46,8189,1,0,231,1,3.0951,1849,619,2225,0
317,1.79002,27,0,46,0,63.175,27,8189,46,0,129,0,3.42269,1895,619,2271,0
494,2.78939,35,0,0,0,74.419,35,8189,0,0,250,0,4.74997,1895,619,2271,0
483,2.72731,43,0,3,0,67.925,43,8190,3,0,196,3,7.30286,1898,622,2274,0
432,2.43927,47,0,4,0,75.864,47,8189,4,0,157,4,5.68189,1902,626,2278,0
455,2.56915,66,0,3,0,88.722,66,8189,3,0,177,3,4.82904,1905,629,2281,0
578,3.26366,87,0,10,0,141.036,116,8191,10,0,166,10,4.24165,1915,639,2291,0
285,1.6093,60,0,120,0,63.192,60,8189,62,0,71,4,4.06091,1977,643,2411,0
495,2.79438,81,0,11,0,109.439,81,8175,11,0,70,11,5.86262,1988,654,2422,0
494,2.78951,97,0,4,0,174.212,99,8189,4,0,133,4,8.27997,1992,658,2426,0
536,3.02658,107,0,9,0,114.708,107,8191,9,0,129,9,8.01451,2001,667,2435,0
481,2.71596,109,0,6,0,115.465,109,8140,6,0,65,6,6.29752,2007,673,2441,0
421,2.37718,74,0,111,0,88.69,74,8191,62,0,121,2,5.58587,2069,675,2552,0
534,3.01521,94,0,4,0,115.063,96,8190,4,0,179,4,6.15632,2073,679,2556,0
386,2.17954,58,0,99,0,66.319,63,8191,61,0,95,3,5.15098,2134,682,2655,0
489,2.76127,80,0,7,0,117.413,80,8145,7,0,114,7,4.62006,2141,689,2662,0
355,2.00412,12,0,90,0,106.077,12,8189,62,0,86,4,4.94765,2203,693,2752,0
534,3.01525,66,0,5,0,106.659,70,8191,5,0,155,5,4.99283,2208,698,2757,0
491,2.77248,79,0,10,0,109.81,79,8169,10,0,134,10,4.55794,2218,708,2767,0
336,1.8973,6,0,88,0,90.002,6,8188,66,0,46,7,4.44498,2284,715,2855,0
473,2.67076,65,0,4,0,93.991,67,8191,4,0,157,4,4.34331,2288,719,2859,0
496,2.79982,76,0,6,0,103.5,76,8189,6,0,153,6,3.54694,2294,725,2865,0
580,3.27495,68,0,9,0,104.222,78,8191,9,0,128,9,3.97054,2303,734,2874,0
548,3.09426,64,0,7,0,110.312,80,8191,7,0,159,7,5.73837,2310,741,2881,0
338,1.90746,19,0,86,0,73.202,21,8189,64,0,83,5,5.61411,2374,746,2967,0
483,2.72726,66,0,70,0,101.122,2,8189,62,0,137,4,4.97589,2436,750,3037,0
332,1.87475,36,0,1,0,65.823,36,8191,2,0,138,1,5.03237,2438,751,3038,0
507,2.86303,58,0,4,0,99.607,58,8191,4,0,204,4,4.91941,2442,755,3042,0
514,2.90239,63,0,7,0,82.119,63,8189,7,0,159,7,5.96994,2449,762,3049,0
440,2.48456,66,0,7,0,112.257,66,8189,7,0,161,7,7.98062,2456,769,3056,0
393,2.21915,36,0,68,0,79.971,36,8189,60,0,141,2,5.7892,2516,771,3124,0
550,3.10585,59,0,3,0,81.614,59,8190,3,0,218,3,5.85698,2519,774,3127,0
424,2.39418,63,0,6,0,85.981,63,8189,6,0,104,6,7.0487,2525,780,3133,0
487,2.74996,35,0,65,0,60.152,35,8189,62,0,174,1,7.21814,2587,781,3198,0
492,2.77835,51,0,3,0,87.469,52,8189,3,0,184,3,6.87362,2590,784,3201,0
436,2.46213,30,0,60,0,46.975,30,8189,60,0,150,3,6.87926,2650,787,3261,0
502,2.83479,36,0,3,0,63.007,36,8189,3,0,221,3,4.34896,2653,790,3264,0
539,3.04373,53,0,4,0,79.27,53,8187,4,0,217,4,5.46726,2657,794,3268,0
383,2.16275,29,0,56,0,48.201,29,8189,56,0,128,2,6.99222,2713,796,3324,0
510,2.87979,36,0,1,0,49.837,36,8189,1,0,244,1,6.29187,2714,797,3325,0
504,2.84592,50,0,5,0,79.244,50,8143,5,0,181,5,6.60251,2719,802,3330,0
451,2.5467,53,0,5,0,65.503,53,8191,5,0,155,5,7.87331,2724,807,3335,0
348,1.96505,27,0,56,0,45.951,27,8191,56,0,91,2,8.40987,2780,809,3391,0
552,3.11711,36,0,0,0,53.223,36,8189,0,0,277,0,7.60786,2780,809,3391,0
470,2.65394,49,0,4,0,85.602,49,8189,4,0,179,4,7.41582,2784,813,3395,0
505,2.85164,28,0,53,0,57.565,28,8189,53,0,195,1,7.8959,2837,814,3448,0
496,2.8009,35,0,2,0,60.235,35,8190,2,0,236,2,7.77165,2839,816,3450,0
545,3.07773,48,0,2,0,81.544,48,8144,2,0,209,2,6.80019,2841,818,3452,0
381,2.15146,25,0,54,0,42.694,25,8189,54,0,132,3,5.3656,2895,821,3506,0
511,2.88552,33,0,1,0,52.259,33,8189,1,0,244,1,5.20746,2896,822,3507,0
429,2.42246,40,0,4,0,64.178,40,8189,4,0,168,4,6.26928,2900,826,3511,0
400,2.2586,26,0,40,0,39.114,26,8189,40,0,175,0,6.15067,2940,826,3551,0
423,2.38856,32,0,2,0,77.636,32,8189,2,0,185,2,6.2128,2942,828,3553,0
487,2.75006,38,0,3,0,75.482,38,8189,3,0,194,3,6.04336,2945,831,3556,0
435,2.45626,43,0,4,0,65.145,43,8189,4,0,147,4,4.26989,2949,835,3560,0
387,2.18531,25,0,48,0,43.052,26,8189,48,0,142,2,3.78981,2997,837,3608,0
516,2.91373,34,0,0,0,51.252,34,8189,0,0,260,0,6.19586,2997,837,3608,0
513,2.89667,44,0,2,0,68.967,44,8189,2,0,238,2,5.79485,2999,839,3610,0
477,2.69358,47,0,7,0,59.672,47,8190,7,0,157,7,5.90781,3006,846,3617,0
527,2.97579,71,0,7,0,85.251,71,8189,7,0,176,7,6.59122,3013,853,3624,0
182,1.02767,9,0,76,0,32.833,9,8189,64,0,47,2,5.33171,3077,855,3700,0
360,2.03274,21,0,0,0,35.389,21,8189,0,0,183,0,3.18547,3077,855,3700,0
479,2.70454,30,0,0,0,49.148,30,8189,0,0,242,0,3.21371,3077,855,3700,0
491,2.77254,37,0,1,0,58.415,37,8189,1,0,232,1,4.19646,3078,856,3701,0
515,2.90806,59,0,3,0,74.034,59,8190,3,0,211,3,4.99848,3081,859,3704,0
442,2.49576,33,0,60,0,64.187,33,8190,60,0,183,1,6.13373,3141,860,3764,0
518,2.92492,47,0,3,0,57.346,47,8189,3,0,194,3,4.87422,3144,863,3767,0
412,2.32636,18,0,57,0,72.545,18,8189,57,0,103,4,5.18486,3201,867,3824,0
446,2.5184,32,0,2,0,63.661,32,8190,2,0,208,2,5.91346,3203,869,3826,0
522,2.94766,40,0,3,0,48.805,40,8189,3,0,200,3,5.66494,3206,872,3829,0
500,2.82326,50,0,4,0,80.995,50,8189,4,0,167,4,5.96994,3210,876,3833,0
478,2.69903,53,0,5,0,86.345,54,8191,5,0,166,5,6.68158,3215,881,3838,0
460,2.59739,64,0,7,0,90.844,64,8189,7,0,144,7,5.54069,3222,888,3845,0
212,1.19708,12,0,67,0,35.942,12,8191,61,0,76,0,5.07755,3283,888,3912,0
415,2.34329,24,0,0,0,36.764,24,8189,0,0,210,0,5.58022,3283,888,3912,0
482,2.72155,32,0,0,0,53.449,32,8191,0,0,243,0,6.37659,3283,888,3912,0
521,2.94183,39,0,2,0,51.478,39,8191,2,0,244,2,6.98658,3285,890,3914,0
506,2.8571,68,0,6,0,89.06,68,8190,6,0,176,6,6.86232,3291,896,3920,0
547,3.08878,107,0,11,0,119.042,107,8191,11,0,111,11,4.13434,3302,907,3931,0
443,2.50154,3,0,143,0,101.601,3,8075,86,0,33,26,4.76126,3388,933,4074,0
498,2.81211,88,0,6,0,105.457,88,8190,6,0,179,6,6.50085,3394,939,4080,0
589,3.3258,77,0,8,0,94.254,97,8189,8,0,67,8,6.32576,3402,947,4088,0
541,3.05493,103,0,17,0,106.066,103,8191,17,0,82,17,7.38194,3419,964,4105,0
384,2.1684,56,0,115,0,59.599,56,8190,82,0,78,11,8.28562,3501,975,4220,0
583,3.29191,73,0,6,0,98.138,89,8189,5,0,176,6,6.35965,3506,981,4226,0
457,2.58045,3,0,105,0,109.97,3,8097,71,0,76,11,6.37659,3577,992,4331,0
411,2.32069,65,0,4,0,118.073,69,8187,4,0,125,4,6.16197,3581,996,4335,0
476,2.68776,70,0,6,0,103.823,79,8189,6,0,78,6,4.3772,3587,1002,4341,0
460,2.59739,86,0,9,0,122.481,86,8189,9,0,121,9,3.50176,3596,1011,4350,0
336,1.89721,53,0,89,0,66.521,53,8191,62,0,73,3,4.29813,3658,1014,4439,0
491,2.77251,66,0,7,0,108.411,72,8191,7,0,113,7,4.96459,3665,1021,4446,0
505,2.8516,77,0,6,0,113.271,80,8189,6,0,139,6,5.73837,3671,1027,4452,0
501,2.82889,75,0,11,0,123.408,82,8189,11,0,96,11,5.83438,3682,1038,4463,0
493,2.78383,84,0,10,0,113.842,84,8191,10,0,98,10,5.44467,3692,1048,4473,0
484,2.73314,85,0,11,0,115.104,85,8191,11,0,81,11,4.44498,3703,1059,4484,0
502,2.83498,52,0,9,0,127.41,86,8154,9,0,78,9,5.42208,3712,1068,4493,0
569,3.21309,57,0,13,0,77.522,87,8189,13,0,87,13,5.85698,3725,1081,4506,0
552,3.11706,78,0,12,0,105.56,90,8191,12,0,106,12,5.05496,3737,1093,4518,0
553,3.12252,77,0,8,0,120.248,98,8189,8,0,116,8,6.24104,3745,1101,4526,0
387,2.18513,106,0,12,0,130.37,106,8167,12,0,74,12,6.10549,3757,1113,4538,0
492,2.77829,71,0,110,0,90.133,73,8191,71,0,121,4,5.37125,3828,1117,4648,0
527,2.97575,92,0,6,0,113.195,92,8189,6,0,142,6,4.84034,3834,1123,4654,0
463,2.61434,99,0,11,0,156.987,99,8191,11,0,138,11,5.04366,3845,1134,4665,0
377,2.12878,60,0,103,0,76.154,60,8189,63,0,84,4,5.5181,3908,1138,4768,0
508,2.86844,76,0,8,0,91.539,80,8191,8,0,99,8,5.06626,3916,1146,4776,0
475,2.68207,87,0,7,0,135.042,87,8191,7,0,87,7,5.56328,3923,1153,4783,0
495,2.79506,93,0,98,0,134.605,2,8161,63,0,118,5,5.48421,3986,1158,4881,0
486,2.7442,66,0,3,0,87.611,74,8189,33,0,167,3,4.54099,4019,1161,4884,0
522,2.94738,83,0,9,0,110.881,83,8189,9,0,111,9,4.49016,4028,1170,4893,0
480,2.71041,87,0,15,0,107.339,87,8190,15,0,89,15,4.64266,4043,1185,4908,0
418,2.36024,4,0,119,0,80.193,4,8191,119,0,21,30,3.99314,4162,1215,5027,0
504,2.84577,68,0,5,0,104.565,71,8189,5,0,159,5,3.91971,4167,1220,5032,0
513,2.89682,78,0,4,0,114.916,80,8189,4,0,117,4,4.53534,4171,1224,5036,0
485,2.7386,58,0,6,0,142.854,84,8189,6,0,135,6,5.76661,4177,1230,5042,0
567,3.20171,84,0,14,0,105.845,85,8189,14,0,80,14,6.3653,4191,1244,5056,0
427,2.41113,62,0,6,0,141.245,87,8191,6,0,104,6,4.90246,4197,1250,5062,0
540,3.04913,64,0,21,0,95.3,87,8141,21,0,62,21,6.34835,4218,1271,5083,0
369,2.08353,11,0,102,0,85.859,11,8189,74,0,34,14,6.99222,4292,1285,5185,0
457,2.58041,30,0,61,0,48.834,30,8191,61,0,166,2,6.6251,4353,1287,5246,0
477,2.69338,37,0,2,0,64.815,37,8189,2,0,225,2,6.13938,4355,1289,5248,0
380,2.14567,24,0,38,0,43.488,24,8189,38,0,164,1,6.24104,4393,1290,5286,0
533,3.00954,33,0,0,0,51.136,33,8189,0,0,267,0,5.00978,4393,1290,5286,0
435,2.45621,38,0,5,0,63.661,38,8189,5,0,156,5,4.02702,4398,1295,5291,0
551,3.11122,64,0,3,0,80.588,64,8191,3,0,208,3,4.41109,4401,1298,5294,0
584,3.29754,64,0,7,0,113.385,111,8189,7,0,138,7,4.98154,4408,1305,5301,0
503,2.84024,105,0,26,0,105.604,118,8186,26,0,25,26,4.70478,4434,1331,5327,0
320,1.80695,58,0,124,0,108.268,69,8189,80,0,93,6,4.51275,4514,1337,5451,0
496,2.80081,96,0,10,0,179.518,96,8171,10,0,141,10,6.23539,4524,1347,5461,0
264,1.49065,3,0,109,0,152.699,3,8092,69,0,25,10,6.31446,4593,1357,5570,0
457,2.58054,67,0,4,0,99.24,73,8189,4,0,136,4,5.90216,4597,1361,5574,0
530,2.99273,89,0,7,0,97.173,89,8190,7,0,163,7,5.5181,4604,1368,5581,0
555,3.13407,65,0,22,0,91.49,92,8189,22,0,59,22,5.28088,4626,1390,5603,0
457,2.5805,12,0,94,0,98.036,12,8191,67,0,48,6,4.74997,4693,1396,5697,0
493,2.78372,59,0,4,0,104.212,70,8189,4,0,138,4,4.42803,4697,1400,5701,0
422,2.38277,81,0,5,0,124.525,81,8190,5,0,134,5,3.19112,4702,1405,5706,0
437,2.4675,52,0,85,0,60.774,52,8189,61,0,116,2,3.48482,4763,1407,5791,0
524,2.95885,74,0,8,0,108.383,74,8189,8,0,161,8,4.07221,4771,1415,5799,0
522,2.94747,79,0,12,0,96.852,79,8189,12,0,147,12,4.73302,4783,1427,5811,0
497,2.80631,81,0,8,0,107.955,81,8191,8,0,112,8,6.58557,4791,1435,5819,0
521,2.94183,77,0,7,0,125.046,82,8189,7,0,129,7,5.9191,4798,1442,5826,0
529,2.98696,58,0,8,0,122.623,84,8191,8,0,118,8,6.70982,4806,1450,5834,0
569,3.21285,74,0,12,0,86.227,88,8191,12,0,113,12,5.99253,4818,1462,5846,0
499,2.81779,65,0,8,0,130.246,92,8191,8,0,59,8,5.62541,4826,1470,5854,0
534,3.01561,104,0,7,0,154.381,104,8177,7,0,111,7,5.98123,4833,1477,5861,0
616,3.47842,67,0,9,0,120.842,128,8189,9,0,118,9,6.82843,4842,1486,5870,0
383,2.1627,57,0,132,0,55.849,62,8189,65,0,77,3,6.53474,4907,1489,6002,0
373,2.10613,3,0,94,0,105.054,3,8103,65,0,77,6,5.82309,4972,1495,6096,0
353,1.99326,21,0,60,0,58.241,21,8189,60,0,103,3,4.16822,5032,1498,6156,0
528,2.98137,36,0,0,0,54.306,36,8189,0,0,263,0,3.71638,5032,1498,6156,0
396,2.23595,22,0,43,0,52.038,22,8189,43,0,155,2,6.30317,5075,1500,6199,0
478,2.69912,31,0,0,0,55.168,31,8189,0,0,242,0,7.06,5075,1500,6199,0
465,2.62559,37,0,2,0,67.292,37,8189,2,0,205,2,4.49016,5077,1502,6201,0
429,2.42234,20,0,42,0,46.586,20,8189,42,0,189,1,3.84064,5119,1503,6243,0
366,2.06674,14,0,24,0,30.3,16,8189,24,0,180,0,3.29278,5143,1503,6267,0
456,2.57498,27,0,0,0,40.298,27,8189,0,0,229,0,3.8011,5143,1503,6267,0
505,2.85167,35,0,0,0,59.775,35,8189,0,0,255,0,3.73333,5143,1503,6267,0
454,2.56355,41,0,5,0,67.143,41,8190,5,0,182,5,3.08946,5148,1508,6272,0
528,2.9813,61,0,4,0,108.604,78,8162,4,0,168,4,4.5184,5152,1512,6276,0
442,2.49578,19,0,109,0,115.101,19,8189,65,0,94,4,4.78386,5217,1516,6385,0
582,3.28637,81,0,8,0,81.996,81,8160,8,0,153,8,4.93635,5225,1524,6393,0
526,2.97029,70,0,12,0,140.949,91,8191,12,0,92,12,4.83469,5237,1536,6405,0
523,2.95332,75,0,12,0,116.524,97,8161,12,0,118,12,6.18456,5249,1548,6417,0
372,2.10059,47,0,109,0,39.635,47,8189,109,0,57,12,6.65334,5358,1560,6526,0
514,2.90224,71,0,9,0,141.909,84,8190,9,0,187,9,6.24104,5367,1569,6535,0
566,3.19567,65,0,11,0,88.41,88,8189,11,0,65,11,6.68158,5378,1580,6546,0
460,2.59756,92,0,9,0,124.385,92,8191,9,0,131,9,7.35934,5387,1589,6555,0
523,2.9533,94,0,17,0,102.997,94,8191,17,0,89,17,5.59717,5404,1606,6572,0
292,1.64878,18,0,151,0,58.188,18,8189,68,0,83,3,4.63701,5472,1609,6723,0
458,2.58609,32,0,3,0,56.508,32,8159,3,0,185,3,4.25859,5475,1612,6726,0
503,2.8402,43,0,3,0,60.549,43,8191,3,0,218,3,5.87957,5478,1615,6729,0
486,2.74429,50,0,4,0,99.736,52,8189,4,0,199,4,6.21845,5482,1619,6733,0
432,2.43936,55,0,9,0,83.96,55,8191,9,0,141,9,5.71578,5491,1628,6742,0
366,2.06662,31,0,56,0,64.807,31,8191,56,0,146,1,5.14533,5547,1629,6798,0
486,2.74426,37,0,0,0,64.007,37,8191,0,0,235,0,6.18456,5547,1629,6798,0
492,2.77808,50,0,4,0,77.114,52,8187,4,0,175,4,7.00352,5551,1633,6802,0
448,2.52957,55,0,4,0,109.059,55,8189,4,0,152,4,7.02046,5555,1637,6806,0
499,2.81772,58,0,5,0,96.935,61,8181,5,0,146,5,7.22379,5560,1642,6811,0
467,2.63706,85,0,5,0,129.468,85,8191,5,0,159,5,7.55138,5565,1647,6816,0
622,3.51223,120,0,11,0,131.974,120,8164,11,0,114,11,7.08824,5576,1658,6827,0
288,1.62619,63,0,124,0,65.003,63,8176,63,0,78,4,7.13907,5639,1662,6951,0
406,2.29247,35,0,64,0,75.901,35,8189,60,0,163,1,6.72112,5699,1663,7015,0
498,2.81191,53,0,2,0,84.865,53,8191,2,0,195,2,7.3537,5701,1665,7017,0
453,2.55785,60,0,7,0,83.293,60,8191,7,0,148,7,7.38194,5708,1672,7024,0
501,2.82893,62,0,7,0,108.668,63,8189,6,0,165,7,5.96994,5714,1679,7031,0
360,2.03283,5,0,69,0,101.736,5,8189,65,0,89,5,5.45032,5779,1684,7100,0
513,2.89691,37,0,1,0,50.767,37,8189,1,0,228,1,4.75562,5780,1685,7101,0
403,2.27563,21,0,57,0,59.47,27,8189,33,0,150,3,7.67563,5813,1688,7158,0
497,2.80627,35,0,1,0,47.812,35,8190,1,0,236,1,6.52344,5814,1689,7159,0
535,3.02084,50,0,2,0,83.359,50,8191,2,0,220,2,5.0945,5816,1691,7161,0
492,2.77808,54,0,6,0,87.733,54,8191,6,0,173,6,5.74402,5822,1697,7167,0
553,3.12251,60,0,4,0,103.788,60,8189,4,0,176,4,6.86232,5826,1701,7171,0
412,2.32625,79,0,6,0,112.536,79,8191,6,0,136,6,6.24104,5832,1707,7177,0
594,3.35416,96,0,12,0,106.025,104,8191,12,0,93,12,6.02642,5844,1719,7189,0
497,2.80648,86,0,12,0,197.601,127,8113,12,0,84,12,5.02107,5856,1731,7201,0
274,1.54717,48,0,134,0,41.234,48,8187,65,0,52,6,4.11739,5921,1737,7335,0
548,3.09428,62,0,6,0,108.576,94,8191,6,0,131,6,3.86888,5927,1743,7341,0
493,2.78378,101,0,9,0,136.063,106,8149,9,0,93,9,5.27523,5936,1752,7350,0
459,2.5919,109,0,44,0,98.908,109,8191,44,0,31,43,5.56893,5980,1795,7394,0
399,2.25299,65,0,118,0,72.323,65,8189,77,0,87,8,6.0603,6057,1803,7512,0
468,2.64256,89,0,10,0,144.94,89,8190,10,0,129,10,6.95834,6067,1813,7522,0
600,3.38785,91,0,14,0,97.009,96,8163,14,0,86,14,5.87957,6081,1827,7536,0
393,2.21907,14,0,120,0,74.689,14,8189,82,0,28,22,4.33202,6163,1849,7656,0
531,2.99825,78,0,11,0,102.86,78,8191,11,0,171,11,4.3885,6174,1860,7667,0
502,2.83451,86,0,16,0,121.104,86,8176,16,0,82,16,5.74966,6190,1876,7683,0
339,1.91415,5,0,112,0,78.426,5,8189,83,0,20,25,5.59152,6273,1901,7795,0
483,2.72713,68,0,8,0,94.227,68,8143,8,0,138,8,5.46162,6281,1909,7803,0
450,2.54088,78,0,10,0,143.014,78,8169,10,0,117,10,5.6593,6291,1919,7813,0
529,2.98688,55,0,10,0,101.953,83,8190,10,0,124,10,4.3659,6301,1929,7823,0
563,3.17917,84,0,12,0,87.354,84,8190,12,0,84,12,4.56923,6313,1941,7835,0
480,2.71035,82,0,7,0,119.919,86,8189,7,0,122,7,4.82904,6320,1948,7842,0
523,2.95312,87,0,14,0,125.12,87,8153,14,0,118,14,5.06626,6334,1962,7856,0
512,2.89125,90,0,7,0,128.919,90,8190,6,0,152,7,4.73867,6340,1969,7863,0
327,1.8464,79,0,103,0,135.514,3,8177,81,0,72,10,4.47322,6421,1979,7966,0
449,2.53533,60,0,7,0,95.193,71,8189,8,0,139,7,4.32637,6429,1986,7973,0
530,2.9927,54,0,14,0,84.534,80,8189,14,0,88,14,5.45597,6443,2000,7987,0
490,2.76696,58,0,85,0,79.68,62,8189,85,0,138,4,5.50115,6528,2004,8072,0
437,2.46761,73,0,9,0,88.73,73,8188,9,0,117,9,5.50115,6537,2013,8081,0
530,2.99268,77,0,7,0,115.976,77,8191,7,0,106,7,3.18547,6544,2020,8088,0
493,2.78383,65,0,7,0,138.736,79,8191,7,0,140,7,2.89178,6551,2027,8095,0
497,2.80641,81,0,8,0,107.964,81,8190,8,0,129,8,4.58618,6559,2035,8103,0
553,3.12254,80,0,7,0,127.718,83,8189,7,0,125,7,5.86827,6566,2042,8110,0
435,2.45624,89,0,9,0,114.723,89,8190,9,0,134,9,5.01542,6575,2051,8119,0
495,2.79502,59,0,92,0,94.949,67,8189,62,0,133,3,4.29813,6637,2054,8211,0
543,3.06612,68,0,6,0,99.109,80,8189,6,0,143,6,6.41613,6643,2060,8217,0
517,2.91945,51,0,9,0,122.204,85,8191,9,0,144,9,6.42742,6652,2069,8226,0
502,2.83464,87,0,7,0,143.761,87,8189,7,0,124,7,7.24074,6659,2076,8233,0
553,3.12265,87,0,6,0,129.908,88,8189,6,0,117,6,8.08229,6665,2082,8239,0
497,2.80658,90,0,9,0,112.605,90,8190,9,0,119,9,7.00352,6674,2091,8248,0
574,3.24113,89,0,16,0,97.345,91,8190,15,0,66,16,5.69883,6689,2107,8264,0
527,2.97566,53,0,13,0,82.954,93,8189,14,0,70,13,4.95894,6703,2120,8277,0
409,2.30941,62,0,97,0,94.114,62,8189,62,0,101,3,4.72738,6765,2123,8374,0
487,2.74983,67,0,6,0,112.076,79,8189,6,0,114,6,3.90842,6771,2129,8380,0
495,2.79501,66,0,7,0,136.617,86,8191,7,0,105,7,4.62006,6778,2136,8387,0
492,2.77807,88,0,12,0,100.944,88,8189,12,0,73,12,3.97619,6790,2148,8399,0
539,3.04347,89,0,32,0,88.188,89,8178,32,0,35,32,3.49046,6822,2180,8431,0
402,2.26987,62,0,94,0,70.11,62,8191,94,0,102,5,3.85758,6916,2185,8525,0
501,2.82892,62,0,7,0,116.492,75,8120,7,0,98,7,3.75027,6923,2192,8532,0
534,3.01535,61,0,9,0,103.96,82,8189,9,0,117,9,4.17952,6932,2201,8541,0
543,3.06618,63,0,8,0,106.624,85,8191,8,0,126,8,5.81744,6940,2209,8549,0
534,3.01539,59,0,10,0,91.449,87,8190,10,0,84,10,5.70448,6950,2219,8559,0
448,2.52984,88,0,9,0,109.918,88,8138,9,0,101,9,4.28683,6959,2228,8568,0
540,3.04908,86,0,8,0,118.69,89,8191,8,0,133,8,5.94734,6967,2236,8576,0
575,3.24689,89,0,7,0,114.322,91,8189,7,0,95,7,4.25294,6974,2243,8583,0
302,1.70526,4,0,100,0,135.983,4,8191,65,0,61,7,4.32072,7039,2250,8683,0
535,3.02097,76,0,6,0,95.297,76,8190,6,0,177,6,5.20181,7045,2256,8689,0
541,3.0548,65,0,8,0,107.676,83,8189,8,0,95,8,5.88522,7053,2264,8697,0
465,2.62563,65,0,8,0,132.034,88,8189,8,0,115,8,5.95864,7061,2272,8705,0
529,2.98697,76,0,8,0,109.752,89,8126,8,0,82,8,5.71578,7069,2280,8713,0
484,2.73289,62,0,94,0,85.693,62,8189,78,0,136,4,4.89682,7147,2284,8807,0
494,2.78937,79,0,5,0,107.039,79,8191,5,0,138,5,5.19616,7152,2289,8812,0
543,3.06611,80,0,6,0,108.936,85,8191,6,0,157,6,6.70982,7158,2295,8818,0
262,1.47945,11,0,98,0,72.706,11,8189,70,0,17,12,7.03176,7228,2307,8916,0
540,3.04912,69,0,8,0,101.78,70,8191,8,0,154,8,5.7779,7236,2315,8924,0
528,2.98131,58,0,9,0,110.01,79,8189,9,0,140,9,4.74432,7245,2324,8933,0
517,2.91921,67,0,11,0,98.104,82,8189,11,0,97,11,5.27523,7256,2335,8944,0
370,2.08901,3,0,89,0,134.429,3,8191,64,0,109,5,5.2244,7320,2340,9033,0
488,2.75564,65,0,6,0,106.789,68,8189,6,0,160,6,6.02642,7326,2346,9039,0
512,2.89098,75,0,9,0,101.602,76,8191,9,0,103,9,3.92536,7335,2355,9048,0
477,2.69336,81,0,8,0,110.982,81,8188,8,0,162,8,4.90811,7343,2363,9056,0
510,2.87969,83,0,12,0,103.505,83,8189,12,0,137,12,4.90811,7355,2375,9068,0
573,3.23539,82,0,13,0,110.931,84,8146,13,0,121,13,3.44528,7368,2388,9081,0
492,2.77806,58,0,11,0,127.293,85,8130,11,0,81,11,4.04397,7379,2399,9092,0
521,2.94189,90,0,12,0,117.416,91,8191,12,0,145,12,4.236,7391,2411,9104,0
503,2.84013,94,0,26,0,109.62,95,8179,26,0,36,26,3.88582,7417,2437,9130,0
435,2.45622,61,0,109,0,73.543,61,8191,105,0,96,14,4.68219,7522,2451,9239,0
460,2.59737,80,0,7,0,121.253,80,8190,7,0,122,7,4.71043,7529,2458,9246,0
364,2.05533,32,0,89,0,59.121,32,8189,62,0,102,4,5.6367,7591,2462,9335,0
503,2.84019,73,0,7,0,103.746,73,8189,7,0,177,7,5.42208,7598,2469,9342,0
461,2.60305,3,0,84,0,128.045,3,8112,64,0,116,5,5.15098,7662,2474,9426,0
482,2.72171,62,0,6,0,103.947,65,8191,6,0,159,6,5.17357,7668,2480,9432,0
452,2.5522,67,0,9,0,131.738,73,8187,9,0,127,9,4.71608,7677,2489,9441,0
508,2.86856,74,0,8,0,142.628,76,8191,8,0,136,8,4.07786,7685,2497,9449,0
341,1.92555,41,0,83,0,50.946,41,8191,65,0,87,6,4.69349,7750,2503,9532,0
375,2.11756,28,0,51,0,43.234,28,8189,51,0,149,1,4.82904,7801,2504,9583,0
493,2.78375,35,0,2,0,59.664,35,8189,2,0,233,2,5.73272,7803,2506,9585,0
389,2.1965,21,0,39,0,33.88,21,8190,39,0,152,2,6.7889,7842,2508,9624,0
477,2.69338,30,0,0,0,56.011,30,8189,0,0,241,0,4.60312,7842,2508,9624,0
429,2.42232,4,0,37,0,54.553,4,8189,37,0,183,2,4.52405,7879,2510,9661,0
437,2.46752,26,0,0,0,42.127,26,8191,0,0,215,0,4.78386,7879,2510,9661,0
465,2.6256,34,0,0,0,47.708,34,8191,0,0,233,0,5.73272,7879,2510,9661,0
542,3.0604,43,0,1,0,74.774,43,8189,1,0,252,1,5.59152,7880,2511,9662,0
477,2.69339,32,0,65,0,47.186,32,8189,65,0,165,3,5.25264,7945,2514,9727,0
497,2.8063,41,0,3,0,60.387,41,8191,3,0,217,3,5.08885,7948,2517,9730,0
275,1.55278,23,0,49,0,68.489,23,8168,49,0,74,2,5.2244,7997,2519,9779,0
470,2.65401,32,0,0,0,63.487,32,8189,0,0,236,0,4.84034,7997,2519,9779,0
479,2.70468,39,0,2,0,59.645,39,8189,2,0,208,2,5.03802,7999,2521,9781,0
548,3.09424,47,0,3,0,61.753,47,8189,3,0,216,3,5.21875,8002,2524,9784,0
480,2.71059,54,0,5,0,93.488,54,8191,5,0,148,5,4.85163,8007,2529,9789,0
508,2.86865,82,0,6,0,98.466,86,8189,6,0,147,6,5.04366,8013,2535,9795,0
486,2.74431,66,0,13,0,126.501,103,8189,13,0,50,13,6.01512,8026,2548,9808,0
318,1.7956,10,0,126,0,115.356,10,8191,116,0,36,15,6.78325,8142,2563,9934,0
428,2.41671,28,0,74,0,61.918,28,8189,58,0,120,4,5.5068,8200,2567,10008,0
549,3.09991,60,0,2,0,86.339,60,8189,2,0,237,2,4.00443,8202,2569,10010,0
395,2.23036,65,0,9,0,92.313,65,8191,9,0,104,9,4.62571,8211,2578,10019,0
557,3.14509,68,0,7,0,121.053,68,8138,7,0,159,7,4.2247,8218,2585,10026,0
346,1.95365,35,0,70,0,54.266,35,8189,60,0,125,1,3.92536,8278,2586,10096,0
508,2.8684,58,0,4,0,72.741,58,8191,4,0,187,4,5.46726,8282,2590,10100,0
430,2.42798,65,0,4,0,118.566,65,8190,4,0,130,4,6.73242,8286,2594,10104,0
482,2.72166,35,0,68,0,57.21,35,8191,64,0,157,2,6.37659,8350,2596,10172,0
436,2.46189,49,0,4,0,89.228,52,8189,4,0,151,4,4.50146,8354,2600,10176,0
346,1.95372,61,0,6,0,119.886,61,8190,6,0,114,6,4.28118,8360,2606,10182,0
527,2.97575,59,0,4,0,109.893,64,8189,4,0,156,4,4.51275,8364,2610,10186,0
498,2.81204,59,0,7,0,96.526,66,8189,7,0,126,7,5.47291,8371,2617,10193,0
457,2.58059,43,0,9,0,106.51,73,8159,9,0,172,9,7.9185,8380,2626,10202,0
565,3.19015,92,0,8,0,100.889,92,8171,8,0,137,8,7.51184,8388,2634,10210,0
548,3.09427,90,0,17,0,119.496,103,8159,17,0,45,17,5.16792,8405,2651,10227,0
353,1.99313,56,0,117,0,58.429,56,8190,72,0,73,12,4.72738,8477,2663,10344,0
532,3.0039,78,0,12,0,92.799,80,8132,12,0,96,12,5.72707,8489,2675,10356,0
506,2.85732,69,0,11,0,96.026,92,8191,11,0,128,11,5.25829,8500,2686,10367,0
594,3.35408,63,0,19,0,88.812,96,8189,19,0,81,19,4.5297,8519,2705,10386,0
511,2.88533,97,0,32,0,107.062,97,8165,32,0,40,32,4.70478,8551,2737,10418,0
404,2.28116,66,0,101,0,76.083,68,8189,63,0,115,4,5.61411,8614,2741,10519,0
545,3.07742,64,0,10,0,126.691,85,8189,10,0,145,10,6.17891,8624,2751,10529,0
546,3.08296,72,0,8,0,105.07,91,8189,8,0,123,8,6.25234,8632,2759,10537,0
560,3.16223,62,0,8,0,98.657,94,8191,8,0,155,8,4.47886,8640,2767,10545,0
360,2.0328,48,0,104,0,49.732,48,8189,69,0,61,10,3.14029,8709,2777,10649,0
483,2.72731,76,0,11,0,98.82,76,8189,11,0,123,11,3.71638,8720,2788,10660,0
565,3.19026,74,0,5,0,111.415,87,8191,5,0,169,5,6.13938,8725,2793,10665,0
554,3.12822,60,0,9,0,103.469,90,8121,9,0,100,9,6.91315,8734,2802,10674,0
471,2.65955,60,0,5,0,168.29,92,8191,5,0,116,5,6.10549,8739,2807,10679,0
574,3.24119,68,0,16,0,98.1,92,8189,16,0,34,16,4.75562,8755,2823,10695,0
539,3.04347,82,0,13,0,74.86,92,8191,13,0,42,13,5.11144,8768,2836,10708,0
526,2.97006,78,0,8,0,129.051,94,8117,8,0,109,8,5.46726,8776,2844,10716,0
421,2.37717,57,0,96,0,72.925,57,8189,60,0,116,2,4.28118,8836,2846,10812,0
453,2.55779,78,0,6,0,96.52,78,8189,6,0,121,6,4.07221,8842,2852,10818,0
534,3.01519,76,0,6,0,119.751,86,8191,6,0,114,6,6.94704,8848,2858,10824,0
521,2.94186,88,0,6,0,109.767,89,8189,6,0,111,6,7.52314,8854,2864,10830,0
503,2.84015,88,0,12,0,102.53,90,8189,12,0,52,12,6.52909,8866,2876,10842,0
438,2.47321,4,0,116,0,84.057,4,8112,112,0,21,25,5.63106,8978,2901,10958,0
450,2.5409,29,0,55,0,48.461,29,8189,55,0,168,1,6.2128,9033,2902,11013,0
446,2.51842,32,0,1,0,75.932,36,8187,1,0,212,1,5.17922,9034,2903,11014,0
495,2.79501,50,0,3,0,84.563,50,8189,3,0,202,3,4.49016,9037,2906,11017,0
506,2.85721,54,0,7,0,107.597,54,8189,7,0,182,7,5.20746,9044,2913,11024,0
468,2.64155,60,0,6,0,96.143,60,8190,6,0,156,6,5.76096,9050,2919,11030,0
515,2.90816,84,0,7,0,102.991,84,8155,7,0,145,7,5.82874,9057,2926,11037,0
529,2.987,105,0,13,0,151.602,116,8191,13,0,105,13,5.79485,9070,2939,11050,0
441,2.49018,123,0,33,0,112.171,123,8182,33,0,26,33,5.23005,9103,2972,11083,0
343,1.93665,68,0,125,0,87.212,68,8190,113,0,87,2,5.80614,9216,2974,11208,0
452,2.55171,89,0,8,0,106.844,89,8189,8,0,79,8,6.39918,9224,2982,11216,0
372,2.10043,61,0,91,0,103.953,62,8191,61,0,103,2,6.16762,9285,2984,11307,0
358,2.02152,76,0,8,0,101.552,76,8189,8,0,105,8,5.68754,9293,2992,11315,0
384,2.16822,24,0,130,0,49.245,24,8189,113,0,103,2,4.9307,9406,2994,11445,0
500,2.82318,34,0,0,0,55.949,34,8191,0,0,249,0,4.97589,9406,2994,11445,0
482,2.72159,44,0,3,0,73.478,44,8189,3,0,187,3,7.99757,9409,2997,11448,0
464,2.61998,50,0,4,0,76.866,50,8190,4,0,169,4,5.23005,9413,3001,11452,0
399,2.25284,30,0,50,0,42.664,30,8189,50,0,166,0,4.00443,9463,3001,11502,0
455,2.56929,3,0,38,0,69.39,3,8155,38,0,195,2,4.34331,9501,3003,11540,0
379,2.14017,25,0,0,0,40.443,25,8189,0,0,185,0,5.41643,9501,3003,11540,0
527,2.97539,34,0,0,0,63.631,34,8189,0,0,266,0,5.63106,9501,3003,11540,0
372,2.10043,18,0,40,0,46.185,18,8189,40,0,129,3,5.45597,9541,3006,11580,0
435,2.45633,27,0,0,0,67.326,27,8189,0,0,218,0,5.52939,9541,3006,11580,0
462,2.60869,34,0,1,0,67.149,34,8189,1,0,219,1,3.41139,9542,3007,11581,0
467,2.63708,41,0,3,0,68.508,41,8189,3,0,200,3,3.17982,9545,3010,11584,0
472,2.66534,69,0,6,0,105.179,70,8189,6,0,151,6,3.36056,9551,3016,11590,0
568,3.20728,105,0,15,0,109.124,105,8155,15,0,94,15,3.58648,9566,3031,11605,0
297,1.67698,9,0,168,0,67.015,3,8145,122,0,66,7,3.02168,9688,3038,11773,0
439,2.47883,33,0,0,0,67.358,33,8191,0,0,210,0,3.21371,9688,3038,11773,0
533,3.00959,48,0,2,0,79.817,48,8190,2,0,250,2,6.33706,9690,3040,11775,0
467,2.63693,28,0,53,0,52.905,28,8189,53,0,177,2,7.76035,9743,3042,11828,0
518,2.92516,36,0,1,0,55.962,36,8189,1,0,242,1,5.98123,9744,3043,11829,0
442,2.49575,47,0,5,0,86.712,47,8190,5,0,182,5,5.31477,9749,3048,11834,0
428,2.41659,29,0,47,0,42.953,29,8191,47,0,180,0,3.75592,9796,3048,11881,0
525,2.96456,36,0,1,0,53.128,36,8189,1,0,250,1,2.99344,9797,3049,11882,0
420,2.37166,23,0,43,0,40.727,23,8189,43,0,179,1,3.47352,9840,3050,11925,0
498,2.81201,31,0,1,0,45.96,31,8189,1,0,237,1,3.88582,9841,3051,11926,0
472,2.66517,37,0,2,0,56.129,37,8189,2,0,207,2,6.19021,9843,3053,11928,0
527,2.97567,44,0,2,0,69.703,44,8189,2,0,230,2,5.74402,9845,3055,11930,0
410,2.31509,8,0,64,0,100.129,8,8189,64,0,121,5,5.74402,9909,3060,11994,0
473,2.67078,35,0,1,0,56.035,35,8189,1,0,214,1,6.89621,9910,3061,11995,0
519,2.93051,52,0,3,0,91.377,52,8190,3,0,214,3,6.5065,9913,3064,11998,0
473,2.6708,54,0,4,0,86.742,57,8189,3,0,138,4,5.55198,9916,3068,12002,0
424,2.39425,59,0,5,0,89.571,59,8190,6,0,128,5,5.20746,9922,3073,12007,0
379,2.13994,32,0,60,0,59.62,32,8191,60,0,137,1,4.42803,9982,3074,12067,0
453,2.55783,37,0,4,0,55.878,37,8189,4,0,183,4,4.04962,9986,3078,12071,0
518,2.92487,54,0,5,0,81.796,54,8189,5,0,165,5,5.96994,9991,3083,12076,0
444,2.50703,18,0,61,0,68.329,18,8189,61,0,162,5,6.33141,10052,3088,12137,0
537,3.03228,36,0,2,0,52.173,36,8191,2,0,250,2,7.12213,10054,3090,12139,0
509,2.87417,52,0,5,0,81.634,52,8189,5,0,188,5,7.31416,10059,3095,12144,0
340,1.91982,28,0,56,0,47.17,28,8191,56,0,107,2,5.83438,10115,3097,12200,0
472,2.66512,35,0,2,0,61.854,35,8189,2,0,224,2,3.51306,10117,3099,12202,0
565,3.19045,50,0,2,0,69.362,50,8189,2,0,221,2,5.32606,10119,3101,12204,0
450,2.54095,53,0,6,0,82.912,53,8189,6,0,154,6,6.5065,10125,3107,12210,0
447,2.52396,25,0,60,0,51.526,25,8189,60,0,134,4,5.89651,10185,3111,12270,0
494,2.78926,35,0,1,0,67.09,35,8189,1,0,234,1,5.21875,10186,3112,12271,0
459,2.59166,49,0,3,0,82.19,49,8189,3,0,187,3,4.5297,10189,3115,12274,0
558,3.1507,55,0,5,0,89.076,55,8189,5,0,183,5,3.76722,10194,3120,12279,0
518,2.92464,57,0,9,0,86.693,59,8189,8,0,181,9,5.04931,10202,3129,12288,0
479,2.7046,55,0,5,0,94.981,78,8191,6,0,151,5,5.74402,10208,3134,12293,0
552,3.11704,66,0,10,0,94.545,102,8191,10,0,89,10,6.13938,10218,3144,12303,0
467,2.63698,67,0,106,0,79.122,67,8165,78,0,115,8,6.90186,10296,3152,12409,0
490,2.76673,71,0,9,0,117.732,83,8189,9,0,100,9,5.7779,10305,3161,12418,0
501,2.82886,87,0,6,0,143.62,91,8191,6,0,118,6,4.16258,10311,3167,12424,0
512,2.89116,93,0,15,0,102.904,93,8170,15,0,60,15,3.93101,10326,3182,12439,0
283,1.59806,7,0,102,0,114.254,7,8189,66,0,55,7,4.20776,10392,3189,12541,0
478,2.69914,72,0,4,0,123.358,73,8189,4,0,147,4,4.66525,10396,3193,12545,0
525,2.96452,73,0,6,0,97.039,85,8189,6,0,126,6,6.0716,10402,3199,12551,0
522,2.94763,88,0,10,0,120.492,88,8191,10,0,78,10,5.31477,10412,3209,12561,0
481,2.71595,90,0,9,0,102.437,90,8190,9,0,63,9,5.89651,10421,3218,12570,0
549,3.09999,93,0,7,0,133.493,93,8191,7,0,144,7,7.48925,10428,3225,12577,0
573,3.23531,87,0,22,0,82.429,93,8189,22,0,63,21,6.29752,10450,3246,12599,0
338,1.90868,37,0,101,0,46.807,37,8191,65,0,118,7,4.86293,10515,3253,12700,0
536,3.02675,76,0,6,0,100.119,80,8191,6,0,187,6,3.93666,10521,3259,12706,0
477,2.69344,88,0,8,0,141.567,88,8189,8,0,151,8,4.63136,10529,3267,12714,0
553,3.12268,71,0,9,0,129.498,90,8189,9,0,93,9,5.42208,10538,3276,12723,0
528,2.98134,89,0,16,0,111.811,91,8169,16,0,62,16,4.21906,10554,3292,12739,0
384,2.16818,45,0,105,0,46.883,45,8189,75,0,60,14,3.64296,10629,3306,12844,0
503,2.84021,75,0,9,0,119.818,76,8191,9,0,142,9,5.10014,10638,3315,12853,0
501,2.82899,58,0,8,0,104.591,84,8190,8,0,132,8,6.30317,10646,3323,12861,0
443,2.50127,61,0,87,0,92.278,61,8190,62,0,117,3,5.77226,10708,3326,12948,0
506,2.85719,71,0,8,0,128.379,75,8191,8,0,140,8,5.65365,10716,3334,12956,0
559,3.15651,76,0,8,0,101.741,81,8189,8,0,163,8,5.90781,10724,3342,12964,0
518,2.92495,81,0,7,0,128.504,82,8191,7,0,140,7,6.89056,10731,3349,12971,0
429,2.42234,84,0,6,0,109.188,84,8191,6,0,111,6,6.69853,10737,3355,12977,0
493,2.78368,86,0,9,0,115.667,86,8157,9,0,128,9,5.72142,10746,3364,12986,0
347,1.95932,59,0,88,0,81.228,59,8190,60,0,94,2,5.35995,10806,3366,13074,0
370,2.08915,34,0,69,0,59.446,34,8190,60,0,115,3,6.98093,10866,3369,13143,0
421,2.37716,45,0,47,0,74.107,2,8189,47,0,159,2,6.88491,10913,3371,13190,0
363,2.04982,28,0,0,0,46.936,28,8189,0,0,175,0,5.98688,10913,3371,13190,0
433,2.44462,31,0,1,0,74.061,34,8189,1,0,205,1,5.29218,10914,3372,13191,0
324,1.82957,21,0,38,0,67.186,21,8189,38,0,124,2,4.70478,10952,3374,13229,0
451,2.54656,30,0,0,0,57.099,30,8189,0,0,229,0,6.86797,10952,3374,13229,0
424,2.39409,36,0,1,0,57.69,36,8189,1,0,199,1,4.99848,10953,3375,13230,0
395,2.23034,4,0,44,0,85.619,4,8178,44,0,147,4,4.85163,10997,3379,13274,0
455,2.56914,28,0,0,0,37.202,28,8189,0,0,221,0,5.68754,10997,3379,13274,0
476,2.68781,35,0,1,0,71.707,35,8189,1,0,223,1,5.99253,10998,3380,13275,0
406,2.29265,39,0,3,0,74.35,39,8189,3,0,170,3,5.61411,11001,3383,13278,0
541,3.05479,59,0,5,0,67.024,59,8191,5,0,198,5,5.52939,11006,3388,13283,0
505,2.85144,95,0,17,0,98.524,95,8169,17,0,110,17,4.86293,11023,3405,13300,0
350,1.97627,59,0,157,0,70.124,2,8177,120,0,84,3,5.25829,11143,3408,13457,0
310,1.7505,32,0,4,0,76.721,32,8191,5,0,129,4,4.04397,11148,3412,13461,0
336,1.89722,36,0,2,0,68.486,36,8190,2,0,126,2,2.95955,11150,3414,13463,0
470,2.65368,51,0,3,0,73.668,52,8189,3,0,178,3,3.90277,11153,3417,13466,0
480,2.71031,57,0,5,0,95.14,57,8189,5,0,166,5,6.56862,11158,3422,13471,0
506,2.85711,4,0,65,0,92.545,4,8191,65,0,140,6,6.54038,11223,3428,13536,0
451,2.54656,34,0,1,0,66.183,34,8189,1,0,204,1,3.5187,11224,3429,13537,0
532,3.00405,50,0,3,0,63.573,50,8189,3,0,210,3,4.51275,11227,3432,13540,0
535,3.02066,57,0,6,0,94,57,8189,6,0,187,6,4.55794,11233,3438,13546,0
490,2.7667,60,0,5,0,101.9,60,8189,5,0,164,5,3.39445,11238,3443,13551,0
316,1.78421,32,0,65,0,52.551,32,8189,61,0,109,3,3.73333,11299,3446,13616,0
382,2.15706,18,0,36,0,48.906,18,8189,36,0,168,1,3.43963,11335,3447,13652,0
502,2.83454,29,0,0,0,48.498,29,8189,0,0,250,0,3.89712,11335,3447,13652,0
512,2.89109,36,0,1,0,69.152,36,8189,1,0,242,1,4.90246,11336,3448,13653,0
495,2.79517,47,0,4,0,62.793,47,8189,4,0,189,4,5.56328,11340,3452,13657,0
455,2.56935,30,0,54,0,33.798,30,8189,54,0,180,2,5.31477,11394,3454,13711,0
451,2.5466,36,0,2,0,70.455,36,8190,2,0,212,2,6.68158,11396,3456,13713,0
510,2.87974,48,0,4,0,79.99,48,8189,4,0,177,4,4.942,11400,3460,13717,0
577,3.258,54,0,3,0,79.358,54,8190,3,0,243,3,4.91941,11403,3463,13720,0
415,2.34329,61,0,6,0,117.644,62,8189,6,0,99,6,5.2131,11409,3469,13726,0
469,2.6482,86,0,8,0,91.116,86,8189,8,0,125,8,5.26394,11417,3477,13734,0
592,3.34266,62,0,7,0,146.436,126,8191,7,0,133,7,5.96994,11424,3484,13741,0
429,2.42232,3,0,146,0,125.712,3,8056,70,0,42,10,6.32576,11494,3494,13887,0
242,1.36653,3,0,59,0,81.153,3,8136,59,0,62,4,4.99283,11553,3498,13946,0
408,2.30376,32,0,1,0,59.9,32,8189,1,0,184,1,3.8011,11554,3499,13947,0
506,2.85712,42,0,2,0,58.928,42,8189,2,0,222,2,3.81805,11556,3501,13949,0
436,2.46192,51,0,5,0,86.891,51,8140,5,0,127,5,5.51245,11561,3506,13954,0
401,2.26422,25,0,57,0,63.493,25,8189,57,0,138,3,7.83942,11618,3509,14011,0
493,2.78385,34,0,0,0,52.039,34,8189,0,0,248,0,7.91285,11618,3509,14011,0
386,2.17953,20,0,38,0,46.842,20,8189,38,0,171,1,7.37064,11656,3510,14049,0
448,2.52965,29,0,1,0,64.267,29,8162,1,0,213,1,7.11648,11657,3511,14050,0
503,2.84018,36,0,2,0,53.379,36,8189,2,0,237,2,6.85102,11659,3513,14052,0
499,2.81761,51,0,3,0,89.143,51,8190,3,0,211,3,6.28622,11662,3516,14055,0
363,2.04963,71,0,9,0,139.15,71,8162,9,0,79,9,5.69883,11671,3525,14064,0
426,2.4054,96,0,19,0,120.991,96,8191,19,0,67,19,5.69318,11690,3544,14083,0
283,1.59795,12,0,120,0,110.452,12,8189,120,0,21,19,6.63075,11810,3563,14203,0
408,2.30376,63,0,9,0,130.34,70,8189,9,0,110,9,6.33706,11819,3572,14212,0
366,2.0666,70,0,12,0,152.237,81,8191,12,0,73,12,6.20715,11831,3584,14224,0
522,2.94756,85,0,13,0,101.718,88,8191,13,0,83,13,5.10014,11844,3597,14237,0
550,3.10562,69,0,8,0,122.396,94,8112,8,0,114,8,4.98154,11852,3605,14245,0
564,3.18458,92,0,16,0,94.997,95,8170,16,0,38,16,6.03771,11868,3621,14261,0
499,2.81761,4,0,131,0,80.333,4,8148,131,0,27,35,6.39354,11999,3656,14392,0
557,3.14517,55,0,3,0,109.162,79,8189,3,0,197,3,4.68784,12002,3659,14395,0
488,2.75549,86,0,11,0,111.514,86,8187,11,0,97,11,5.73837,12013,3670,14406,0
388,2.1908,0,0,97,0,114.409,3,8103,69,0,41,9,6.30882,12082,3679,14503,0
498,2.81191,63,0,3,0,85.877,68,8191,3,0,141,3,4.87422,12085,3682,14506,0
490,2.76675,64,0,8,0,112.529,79,8152,8,0,121,8,4.78386,12093,3690,14514,0
452,2.55219,78,0,6,0,132.115,83,8189,6,0,106,6,6.12808,12099,3696,14520,0
541,3.05475,85,0,10,0,106.932,85,8148,10,0,111,10,5.32042,12109,3706,14530,0
569,3.21283,86,0,8,0,93.664,86,8191,8,0,99,8,6.03771,12117,3714,14538,0
525,2.9644,71,0,6,0,98.956,87,8189,6,0,97,6,6.30317,12123,3720,14544,0
504,2.84573,88,0,12,0,102.083,88,8191,12,0,87,12,6.72677,12135,3732,14556,0
332,1.87461,52,0,93,0,85.763,52,8189,63,0,68,5,7.42712,12198,3737,14649,0
343,1.93674,31,0,62,0,68.273,31,8189,61,0,127,3,5.92475,12259,3740,14711,0
462,2.60868,36,0,4,0,63.205,36,8183,4,0,186,4,4.87987,12263,3744,14715,0
505,2.85161,52,0,3,0,92.262,54,8189,3,0,178,3,4.45062,12266,3747,14718,0
377,2.12875,15,0,62,0,74.363,15,8189,62,0,102,6,3.51306,12328,3753,14780,0
494,2.78939,34,0,1,0,59.76,34,8189,1,0,229,1,4.98154,12329,3754,14781,0
528,2.98149,49,0,3,0,70.553,49,8189,3,0,204,3,4.62571,12332,3757,14784,0
456,2.57475,54,0,8,0,79.554,54,8190,8,0,155,8,4.73302,12340,3765,14792,0
248,1.40034,14,0,57,0,32.03,14,8191,57,0,97,0,5.99818,12397,3765,14849,0
437,2.46751,25,0,0,0,44.316,25,8189,0,0,221,0,6.46131,12397,3765,14849,0
445,2.51268,33,0,0,0,68.797,33,8189,0,0,226,0,6.41613,12397,3765,14849,0
487,2.74989,39,0,2,0,69.712,39,8189,2,0,215,2,5.26394,12399,3767,14851,0
480,2.7103,63,0,5,0,87.553,63,8189,5,0,170,5,5.17357,12404,3772,14856,0
544,3.07168,99,0,10,0,129.079,99,8150,10,0,104,10,5.26394,12414,3782,14866,0
575,3.24671,86,0,11,0,146.037,132,8190,11,0,121,11,4.3885,12425,3793,14877,0
360,2.03273,24,0,153,0,63.281,24,8191,77,0,32,18,4.65395,12502,3811,15030,0
544,3.07167,66,0,11,0,96.721,86,8190,11,0,114,11,3.88018,12513,3822,15041,0
471,2.65944,92,0,10,0,168.218,106,8162,10,0,101,10,4.08915,12523,3832,15051,0
428,2.41668,55,0,111,0,57.751,55,8191,60,0,93,2,5.41643,12583,3834,15162,0
478,2.69905,64,0,10,0,135.247,86,8189,10,0,126,10,4.68784,12593,3844,15172,0
557,3.14439,83,0,7,0,82.871,93,8189,7,0,70,7,4.16822,12600,3851,15179,0
505,2.85165,79,0,6,0,134.639,100,8189,6,0,120,6,4.03267,12606,3857,15185,0
529,2.98693,102,0,21,0,92.325,102,8191,21,0,60,21,5.99253,12627,3878,15206,0
288,1.62592,62,0,106,0,86.856,62,8189,62,0,86,4,6.14502,12689,3882,15312,0
391,2.20793,36,0,78,0,65.732,36,8191,64,0,110,5,3.75592,12753,3887,15390,0
370,2.08934,57,0,4,0,116.785,57,8189,4,0,123,4,3.71638,12757,3891,15394,0
580,3.27482,69,0,7,0,83.342,69,8189,7,0,199,7,5.52374,12764,3898,15401,0
546,3.08205,71,0,5,0,104.974,72,8189,5,0,172,5,6.48955,12769,3903,15406,0
482,2.72151,75,0,6,0,124.587,75,8190,6,0,175,6,6.54038,12775,3909,15412,0
358,2.02142,43,0,80,0,60.522,43,8189,80,0,87,3,7.14472,12855,3912,15492,0
581,3.28061,56,0,6,0,105.254,71,8189,6,0,210,6,5.8005,12861,3918,15498,0
463,2.61431,74,0,9,0,113.055,74,8190,9,0,123,9,5.39384,12870,3927,15507,0
532,3.00382,69,0,5,0,109.789,75,8191,5,0,106,5,6.21845,12875,3932,15512,0
474,2.67661,75,0,5,0,103.944,77,8189,5,0,125,5,6.25798,12880,3937,15517,0
393,2.21913,6,0,83,0,134.838,6,8191,62,0,127,3,6.86797,12942,3940,15600,0
470,2.654,62,0,4,0,123.41,66,8191,4,0,160,4,7.44406,12946,3944,15604,0
486,2.74443,73,0,9,0,129.517,73,8191,9,0,109,9,7.47795,12955,3953,15613,0
487,2.74983,77,0,8,0,126.955,77,8165,8,0,158,8,6.2128,12963,3961,15621,0
483,2.72713,79,0,10,0,107.382,79,8190,10,0,122,10,6.05466,12973,3971,15631,0
587,3.3145,81,0,6,0,84.094,81,8191,6,0,143,6,5.10579,12979,3977,15637,0
527,2.97578,85,0,8,0,134.967,85,8161,8,0,125,8,5.54634,12987,3985,15645,0


