SendPacket,SendRate(Mb/s),FlightSize,ReceiveRate(Mb/s),Send Loss,Recv Loss,RTT(ms),CWnd,FlowWindow,Retrans,PktSndPeriod(us),RecvACK,RecvNAK,EstimatedBandwidth(Mb/s),Retrans_Total,NAK_TotalRecv,Total Send Loss,Total Recv Loss
670,7.42784,163,0,3,0,96.951,173,8189,3,0,171,3,10.0522,3,3,3,0
710,8.26848,81,0,9,0,100.541,299,8163,9,0,126,9,16.6916,12,12,12,0
649,7.55817,57,0,315,0,42.383,57,8189,122,0,59,12,12.6847,134,24,327,0
783,9.11766,63,0,6,0,75.885,151,8189,6,0,201,6,11.9043,140,30,333,0
751,8.74386,152,0,6,0,74.472,153,8190,6,0,151,6,15.6782,146,36,339,0
760,8.85024,113,0,6,0,90.805,157,8190,6,0,175,6,14.1523,152,42,345,0
815,9.49059,67,0,8,0,105.306,164,8189,8,0,151,8,15.1191,160,50,353,0
641,7.46452,166,0,20,0,90.068,166,8175,20,0,51,20,14.6648,180,70,373,0
687,8.0009,84,0,172,0,70.107,84,8191,65,0,200,6,18.334,245,76,545,0
792,9.22333,98,0,5,0,92.212,100,8190,5,0,248,5,14.5949,250,81,550,0
803,9.35004,93,0,10,0,106.542,128,8157,10,0,150,10,14.4435,260,91,560,0
793,9.23473,5,0,160,0,107.964,5,8191,113,0,63,22,14.6881,373,113,720,0
743,8.65267,72,0,4,0,73.51,74,8189,4,0,241,4,16.1558,377,117,724,0
719,8.37319,111,0,3,0,86.885,111,8189,3,0,256,3,16.412,380,120,727,0
837,9.74799,86,0,7,0,86.642,173,8190,7,0,276,7,20.6053,387,127,734,0
683,7.95465,74,0,162,0,97.24,78,8189,92,0,164,7,17.4487,479,134,896,0
724,8.43223,88,0,6,0,70.999,91,8190,6,0,251,6,11.6829,485,140,902,0
715,8.32713,15,0,134,0,82.464,3,8191,66,0,187,5,15.2822,551,145,1036,0
636,7.40677,65,0,3,0,89.984,69,8189,18,0,220,3,16.016,569,148,1039,0
758,8.82737,67,0,4,0,92.518,109,8189,4,0,255,4,17.2623,573,152,1043,0
732,8.52416,79,0,3,0,127.09,152,8189,3,0,175,3,16.4237,576,155,1046,0
775,9.0248,106,0,8,0,154.496,195,8169,8,0,235,8,15.2006,584,163,1054,0
791,9.21107,114,0,5,0,103.915,224,8191,5,0,189,5,13.931,589,168,1059,0
846,9.85201,82,0,12,0,123.786,241,8189,12,0,125,12,15.8296,601,180,1071,0
816,9.50249,133,0,4,0,85.221,265,8191,4,0,190,4,15.3055,605,184,1075,0
738,8.59442,88,0,8,0,137.985,277,8189,8,0,105,8,17.6001,613,192,1083,0
811,9.44501,152,0,8,0,85.452,294,8191,8,0,150,8,16.0393,621,200,1091,0
723,8.41997,95,0,20,0,97.881,298,8191,20,0,37,20,13.6398,641,220,1111,0
658,7.663,301,0,52,0,78.539,301,8191,52,0,25,50,12.9759,693,270,1163,0
735,8.55982,126,0,310,0,86.519,150,8190,209,0,159,9,16.249,902,279,1473,0
769,8.95603,4,0,168,0,82.29,4,8156,119,0,60,20,14.9444,1021,299,1641,0
702,8.17537,78,0,4,0,102.613,79,8173,4,0,257,4,15.0143,1025,303,1645,0
702,8.17534,62,0,4,0,137.66,106,8189,4,0,235,4,12.8128,1029,307,1649,0
628,7.31305,9,0,132,0,64.359,9,8191,100,0,69,9,15.9811,1129,316,1781,0
721,8.39628,71,0,3,0,79.244,71,8189,3,0,272,3,17.8447,1132,319,1784,0
752,8.75717,65,0,5,0,102.112,131,8189,5,0,269,5,19.1843,1137,324,1789,0
832,9.68921,86,0,5,0,83.547,176,8189,5,0,218,5,16.4353,1142,329,1794,0
811,9.44505,88,0,3,0,119.546,220,8191,3,0,271,3,13.8728,1145,332,1797,0
756,8.80423,109,0,9,0,120.546,242,8158,9,0,160,9,18.7183,1154,341,1806,0
786,9.15299,121,0,11,0,204,261,8150,11,0,150,11,16.6916,1165,352,1817,0
880,10.2477,96,0,1,0,89.723,301,8189,1,0,352,1,18.4854,1166,353,1818,0
782,9.10662,144,0,12,0,88.329,313,8191,12,0,115,12,17.0876,1178,365,1830,0
766,8.92041,85,0,7,0,127.519,329,8191,7,0,156,7,18.0428,1185,372,1837,0
797,9.28151,97,0,6,0,139.588,345,7976,6,0,169,6,18.9396,1191,378,1843,0
802,9.33965,82,0,4,0,111.446,361,8189,4,0,182,4,12.8594,1195,382,1847,0
825,9.60751,92,0,13,0,112.483,375,8160,13,0,162,13,15.4569,1208,395,1860,0
807,9.39856,102,0,9,0,117.257,389,8191,9,0,165,9,14.2572,1217,404,1869,0
795,9.2574,116,0,5,0,143.715,399,8189,5,0,121,5,16.8896,1222,409,1874,0
801,9.32776,161,0,7,0,117.236,415,8190,7,0,202,7,17.0643,1229,416,1881,0
716,8.33769,92,0,286,0,75.305,142,8189,119,0,149,2,15.0492,1348,418,2167,0
737,8.58212,63,0,6,0,68.305,143,8191,6,0,201,6,11.9392,1354,424,2173,0
786,9.15299,74,0,7,0,84.295,148,8189,7,0,206,7,15.9578,1361,431,2180,0
734,8.5472,75,0,7,0,159.638,154,8189,7,0,122,7,12.4517,1368,438,2187,0
778,9.06051,106,0,5,0,100.958,177,8185,5,0,244,5,14.8396,1373,443,2192,0
839,9.77066,85,0,5,0,81.783,217,8189,5,0,242,5,13.0924,1378,448,2197,0
561,6.53318,3,0,233,0,97.841,3,7972,105,0,18,14,12.6614,1483,462,2430,0
698,8.12882,75,0,3,0,77.077,109,8189,3,0,204,3,13.8262,1486,465,2433,0
832,9.68925,78,0,5,0,83.145,118,8189,5,0,276,5,14.793,1491,470,2438,0
753,8.76928,94,0,6,0,104.043,137,8190,6,0,195,6,17.6467,1497,476,2444,0
813,9.46777,155,0,7,0,76.377,161,8189,7,0,122,7,17.2274,1504,483,2451,0
755,8.79219,126,0,8,0,71.231,200,8171,8,0,221,8,16.4819,1512,491,2459,0
738,8.5946,170,0,9,0,219.433,214,8189,9,0,89,9,13.0574,1521,500,2468,0
714,8.31422,61,0,8,0,84.816,238,8189,8,0,169,8,11.7295,1529,508,2476,0
818,9.52546,123,0,7,0,85.107,265,8189,6,0,218,7,14.8163,1535,515,2483,0
797,9.28095,120,0,10,0,84.141,281,8189,11,0,134,10,15.2705,1546,525,2493,0
803,9.3513,74,0,6,0,80.532,305,8191,6,0,219,6,18.7533,1552,531,2499,0
721,8.39587,231,0,16,0,108.139,311,8144,16,0,56,16,16.214,1568,547,2515,0
449,5.22866,104,0,321,0,79.68,104,8189,69,0,102,10,12.8943,1637,557,2836,0
801,9.32796,60,0,7,0,86.519,156,8125,7,0,213,7,16.3421,1644,564,2843,0
757,8.81598,79,0,8,0,129.28,157,8191,8,0,138,8,17.4953,1652,572,2851,0
778,9.06016,142,0,6,0,163.915,160,8191,6,0,132,6,16.2839,1658,578,2857,0
783,9.11869,58,0,5,0,80.565,169,8189,5,0,209,5,14.7114,1663,583,2862,0
790,9.2006,146,0,18,0,85.37,179,8191,18,0,106,18,14.164,1681,601,2880,0
896,10.4353,153,0,10,0,97.744,187,8191,10,0,82,10,13.5233,1691,611,2890,0
804,9.36343,59,0,6,0,96.965,220,8109,6,0,214,6,17.7166,1697,617,2896,0
777,9.04932,129,0,18,0,91.945,231,8155,18,0,75,18,16.3305,1715,635,2914,0
822,9.57261,112,0,24,0,114.148,250,8191,24,0,139,24,12.8361,1739,659,2938,0
790,9.20005,74,0,4,0,115.103,276,8191,4,0,220,4,14.1756,1743,663,2942,0
795,9.25773,142,0,6,0,147.888,300,8190,6,0,212,6,15.7248,1749,669,2948,0
790,9.19947,115,0,8,0,155.082,316,8190,8,0,161,8,16.5169,1757,677,2956,0
470,5.47341,66,0,320,0,42.45,76,8189,62,0,74,4,13.4418,1819,681,3276,0
771,8.97825,107,0,8,0,103.794,158,8157,8,0,195,8,12.6963,1827,689,3284,0
812,9.45592,146,0,6,0,126.856,160,8189,6,0,189,6,12.2188,1833,695,3290,0
593,6.90547,4,0,170,0,118.315,4,8189,67,0,99,8,14.4435,1900,703,3460,0
711,8.27894,74,0,5,0,83.948,84,8189,5,0,244,5,13.7097,1905,708,3465,0
677,7.88335,95,0,6,0,90.736,95,8189,6,0,178,6,14.3503,1911,714,3471,0
791,9.21195,67,0,6,0,134.519,140,8189,6,0,218,6,13.9077,1917,720,3477,0
691,8.04759,140,0,4,0,126.168,182,8154,4,0,214,4,13.5699,1921,724,3481,0
573,6.67341,60,0,191,0,57.367,60,8189,91,0,70,7,16.3072,2012,731,3672,0
719,8.37392,61,0,8,0,95.569,94,8189,8,0,196,8,12.8943,2020,739,3680,0
758,8.82792,69,0,6,0,79.64,103,8191,6,0,180,6,12.0324,2026,745,3686,0
776,9.03775,145,0,2,0,112.98,149,8189,2,0,275,2,16.8197,2028,747,3688,0
763,8.885,53,0,3,0,88.848,196,8189,3,0,252,3,16.2257,2031,750,3691,0
808,9.40957,119,0,9,0,99.374,219,8191,9,0,148,9,16.1791,2040,759,3700,0
847,9.86376,71,0,6,0,109.881,241,8189,6,0,158,6,19.522,2046,765,3706,0
792,9.22301,105,0,9,0,87.925,257,8191,9,0,126,9,15.8063,2055,774,3715,0
768,8.94336,77,0,5,0,87.652,284,8189,5,0,228,5,13.9077,2060,779,3720,0
821,9.56056,82,0,20,0,103.79,292,8114,20,0,71,20,13.3719,2080,799,3740,0
803,9.35086,133,0,11,0,101.528,308,8190,11,0,151,11,12.7196,2091,810,3751,0
619,7.20823,94,0,311,0,62.35,109,8191,146,0,107,3,16.1092,2237,813,4062,0
778,9.05992,155,0,2,0,131.713,155,8190,2,0,267,2,17.7632,2239,815,4064,0
869,10.1207,107,0,5,0,108.648,160,8191,5,0,211,5,13.3719,2244,820,4069,0
734,8.54791,104,0,9,0,100.427,166,8191,9,0,148,9,13.5699,2253,829,4078,0
698,8.12873,73,0,171,0,91.534,84,8189,78,0,222,4,18.2641,2331,833,4249,0
754,8.78098,93,0,7,0,70.599,95,8189,7,0,195,7,18.497,2338,840,4256,0
753,8.76974,113,0,8,0,95.09,127,8191,8,0,193,8,13.9194,2346,848,4264,0
646,7.52299,146,0,18,0,90.603,146,8191,18,0,84,18,13.2321,2364,866,4282,0
571,6.64956,74,0,151,0,77.007,74,8158,65,0,171,5,17.1342,2429,871,4433,0
734,8.54742,92,0,3,0,80.349,96,8190,3,0,265,3,20.1277,2432,874,4436,0
689,8.02427,110,0,6,0,143.618,140,8190,6,0,187,6,15.5384,2438,880,4442,0
839,9.77099,106,0,7,0,74.876,177,8144,7,0,182,7,14.5251,2445,887,4449,0
843,9.81747,63,0,7,0,65.335,205,8189,7,0,168,7,15.4452,2452,894,4456,0
809,9.42137,75,0,10,0,103.248,219,8189,10,0,91,10,15.2822,2462,904,4466,0
811,9.44436,127,0,4,0,144.029,250,8190,4,0,226,4,15.2589,2466,908,4470,0
844,9.82957,189,0,3,0,114.241,274,8185,3,0,200,3,16.5518,2469,911,4473,0
729,8.48975,95,0,11,0,110.865,294,8191,11,0,175,11,14.6415,2480,922,4484,0
548,6.3819,99,0,298,0,60.058,99,8191,63,0,97,4,13.698,2543,926,4782,0
817,9.51462,149,0,2,0,188.092,149,8191,2,0,300,2,18.8232,2545,928,4784,0
812,9.45646,129,0,4,0,73.442,156,8189,4,0,246,4,15.6083,2549,932,4788,0
822,9.57343,140,0,5,0,77.396,173,8189,5,0,233,5,15.5501,2554,937,4793,0
775,9.02554,78,0,8,0,95.1,200,8109,8,0,182,8,15.818,2562,945,4801,0
789,9.18795,119,0,4,0,94.328,230,8191,4,0,204,4,17.076,2566,949,4805,0
733,8.536,90,0,11,0,88.549,242,8156,11,0,91,11,13.5932,2577,960,4816,0
841,9.79302,96,0,18,0,75.06,260,8191,17,0,137,18,11.4966,2594,978,4834,0
841,9.79391,264,0,296,0,72.687,2,8191,88,0,30,32,10.5414,2682,1010,5130,0
641,7.46481,132,0,4,0,103.251,132,8190,5,0,195,4,11.2986,2687,1014,5134,0
792,9.22321,98,0,2,0,145.093,137,8189,2,0,290,2,15.2938,2689,1016,5136,0
743,8.6526,128,0,7,0,79.122,145,8191,7,0,169,7,15.2239,2696,1023,5143,0
767,8.93247,153,0,5,0,151.628,165,8189,4,0,195,5,13.2787,2700,1028,5148,0
768,8.94369,79,0,11,0,94.634,186,8189,12,0,115,11,16.645,2712,1039,5159,0
799,9.30514,116,0,13,0,87.612,208,8191,13,0,135,13,13.4418,2725,1052,5172,0
494,5.75318,55,0,218,0,51.144,55,8189,153,0,57,10,13.6165,2878,1062,5390,0
758,8.8275,100,0,8,0,79.011,105,8190,8,0,191,8,17.6584,2886,1070,5398,0
795,9.2584,71,0,106,0,71.235,73,8189,99,0,310,1,15.3055,2985,1071,5504,0
777,9.04894,145,0,3,0,94.768,145,8190,3,0,268,3,12.6381,2988,1074,5507,0
834,9.71271,167,0,4,0,79.415,188,8191,4,0,223,4,13.2088,2992,1078,5511,0
753,8.76888,177,0,4,0,102.262,219,8189,4,0,200,4,12.8012,2996,1082,5515,0
798,9.29239,130,0,11,0,137.371,239,8157,11,0,141,11,14.3503,3007,1093,5526,0
837,9.74668,110,0,13,0,183.111,252,8191,13,0,98,13,14.3736,3020,1106,5539,0
734,8.54738,77,0,7,0,126.486,268,8191,7,0,135,7,10.1571,3027,1113,5546,0
859,10.003,65,0,8,0,87.483,284,8191,8,0,140,8,13.6282,3035,1121,5554,0
798,9.29279,70,0,11,0,91.786,303,8189,11,0,174,11,16.2373,3046,1132,5565,0
752,8.75715,119,0,14,0,112.674,314,8166,14,0,104,14,17.8564,3060,1146,5579,0
669,7.79108,74,0,317,0,87.749,113,8191,113,0,111,3,16.214,3173,1149,5896,0
855,9.95709,78,0,13,0,84.755,157,8191,13,0,136,13,13.6631,3186,1162,5909,0
721,8.3967,66,0,140,0,80.517,69,8189,92,0,204,5,13.966,3278,1167,6049,0
780,9.08377,62,0,5,0,101.855,95,8180,5,0,288,5,15.4569,3283,1172,6054,0
772,8.99068,115,0,9,0,76.936,139,8190,9,0,175,9,14.956,3292,1181,6063,0
807,9.39894,65,0,9,0,88.202,172,8189,9,0,160,9,13.6631,3301,1190,6072,0
778,9.06069,155,0,5,0,112.214,205,8191,5,0,198,5,14.2222,3306,1195,6077,0
807,9.398,134,0,12,0,100.415,227,8169,12,0,148,12,16.2606,3318,1207,6089,0
559,6.50942,113,0,232,0,87.196,113,8189,95,0,133,5,15.3055,3413,1212,6321,0
758,8.82689,115,0,5,0,82.015,115,8189,5,0,203,5,15.2822,3418,1217,6326,0
815,9.49061,61,0,3,0,94.727,139,8191,3,0,347,3,13.7912,3421,1220,6329,0
775,9.02483,177,0,5,0,144.555,181,8190,5,0,232,5,14.2921,3426,1225,6334,0
777,9.04808,59,0,3,0,178.032,219,8189,3,0,233,3,14.6648,3429,1228,6337,0
761,8.86198,92,0,6,0,118.646,244,8189,6,0,185,6,16.5751,3435,1234,6343,0
833,9.70098,114,0,5,0,103.274,274,8189,5,0,245,5,16.5402,3440,1239,6348,0
795,9.25733,96,0,2,0,145.503,301,8189,2,0,238,2,14.8512,3442,1241,6350,0
781,9.09455,123,0,7,0,85.205,316,8191,7,0,144,7,15.387,3449,1248,6357,0
848,9.87532,75,0,258,0,72.231,127,8191,131,0,265,3,15.4336,3580,1251,6615,0
824,9.59603,64,0,6,0,105.01,132,8189,6,0,216,6,13.535,3586,1257,6621,0
787,9.16494,95,0,7,0,79.323,142,8191,7,0,191,7,15.7714,3593,1264,6628,0
860,10.0158,71,0,11,0,80.726,151,8189,11,0,83,11,12.9176,3604,1275,6639,0
801,9.32818,94,0,2,0,125.753,198,8189,2,0,292,2,14.4435,3606,1277,6641,0
831,9.67677,124,0,7,0,102.493,221,8191,7,0,154,7,14.4901,3613,1284,6648,0
809,9.42127,177,0,11,0,92.799,242,8189,11,0,150,11,13.6049,3624,1295,6659,0
819,9.53756,69,0,8,0,80.289,266,8189,8,0,190,8,16.4936,3632,1303,6667,0
849,9.88652,178,0,8,0,78.136,284,8189,8,0,154,8,13.9194,3640,1311,6675,0
791,9.21106,64,0,7,0,105.003,299,8126,7,0,140,7,16.0742,3647,1318,6682,0
810,9.43245,141,0,4,0,125.867,324,8190,4,0,238,4,15.5035,3651,1322,6686,0
851,9.90989,81,0,4,0,108.422,346,8189,4,0,236,4,17.5302,3655,1326,6690,0
820,9.54898,98,0,6,0,137.683,361,8189,6,0,160,6,17.7283,3661,1332,6696,0
1032,12.0178,325,0,2,0,190.679,387,8191,2,0,311,2,17.1109,3663,1334,6698,0
824,9.59608,94,0,16,0,111.168,404,8165,16,0,206,16,13.733,3679,1350,6714,0
598,6.96396,14,0,429,0,76.229,14,8191,203,0,14,25,15.7597,3882,1375,7143,0
809,9.42113,77,0,4,0,93.468,202,8189,4,0,263,4,14.2339,3886,1379,7147,0
807,9.398,174,0,13,0,76.451,202,8144,13,0,78,13,15.4918,3899,1392,7160,0
547,6.36992,97,0,208,0,77.25,101,8189,65,0,140,6,15.6666,3964,1398,7368,0
728,8.4782,102,0,8,0,100.439,105,8189,8,0,215,8,18.1126,3972,1406,7376,0
778,9.05964,122,0,7,0,90.789,127,8161,7,0,254,7,19.4871,3979,1413,7383,0
600,6.98587,53,0,147,0,42.408,53,8189,74,0,91,15,18.6252,4053,1428,7530,0
567,6.6029,12,0,74,0,90.508,12,8189,74,0,176,5,18.4388,4127,1433,7604,0
803,9.35127,96,0,1,0,87.938,101,8189,1,0,332,1,17.9962,4128,1434,7605,0
795,9.25689,137,0,4,0,97.678,163,8191,4,0,257,4,17.9263,4132,1438,7609,0
838,9.75874,84,0,4,0,100.288,199,8189,4,0,205,4,13.4185,4136,1442,7613,0
790,9.2,101,0,6,0,80.504,231,8129,6,0,216,6,14.2572,4142,1448,7619,0
794,9.24638,110,0,8,0,77.312,252,8191,8,0,159,8,12.1139,4150,1456,7627,0
797,9.28136,121,0,9,0,88.165,265,8191,9,0,102,9,13.1739,4159,1465,7636,0
781,9.09571,181,0,4,0,119.088,288,8191,4,0,199,4,16.8314,4163,1469,7640,0
804,9.3632,81,0,5,0,127.692,304,8189,5,0,150,5,17.9496,4168,1474,7645,0
774,9.01382,63,0,11,0,89.304,316,8189,11,0,117,11,14.6182,4179,1485,7656,0
796,9.26996,76,0,163,0,86.43,76,8191,75,0,155,10,18.9979,4254,1495,7819,0
741,8.62974,66,0,4,0,79.329,85,8191,4,0,212,4,18.0078,4258,1499,7823,0
820,9.54871,59,0,3,0,75.01,141,8189,3,0,290,3,12.3236,4261,1502,7826,0
489,5.69437,70,0,146,0,93.084,70,8191,64,0,107,5,17.2623,4325,1507,7972,0
756,8.80365,96,0,4,0,99.736,96,8190,4,0,333,4,17.2041,4329,1511,7976,0
764,8.89735,80,0,3,0,93.043,154,8189,3,0,238,3,15.2822,4332,1514,7979,0
796,9.26959,86,0,4,0,99.389,202,8189,4,0,270,4,13.5117,4336,1518,7983,0
756,8.80386,83,0,5,0,198.035,222,8189,5,0,135,5,12.5798,4341,1523,7988,0
833,9.70124,99,0,6,0,98.632,255,8189,6,0,240,6,16.9828,4347,1529,7994,0
773,9.00155,64,0,7,0,151.201,277,8190,7,0,185,7,12.3119,4354,1536,8001,0
785,9.14195,183,0,5,0,92.274,298,8189,5,0,187,5,18.0544,4359,1541,8006,0
741,8.62959,9,0,135,0,76.339,9,8189,135,0,99,15,15.8646,4494,1556,8141,0
733,8.53611,71,0,4,0,82.262,71,8191,4,0,280,4,19.324,4498,1560,8145,0
701,8.16362,50,0,103,0,48.844,50,8189,61,0,217,2,17.5186,4559,1562,8248,0
745,8.67598,62,0,4,0,79.671,82,8118,3,0,284,4,16.4237,4562,1566,8252,0
774,9.01418,138,0,4,0,102.136,144,8191,5,0,219,4,13.698,4567,1570,8256,0
749,8.7223,62,0,6,0,132.87,184,8191,6,0,204,6,15.0842,4573,1576,8262,0
830,9.66529,65,0,199,0,77.81,97,8191,130,0,235,4,14.1523,4703,1580,8461,0
652,7.59242,65,0,7,0,112.637,102,8191,7,0,181,7,13.966,4710,1587,8468,0
760,8.85005,76,0,6,0,91.619,112,8189,6,0,158,6,15.3055,4716,1593,8474,0
776,9.03646,135,0,10,0,108.786,143,8167,10,0,187,10,15.0725,4726,1603,8484,0
655,7.62745,161,0,15,0,86.582,161,8162,15,0,86,15,12.7779,4741,1618,8499,0
609,7.09184,82,0,161,0,76.01,82,8189,59,0,240,0,19.2774,4800,1618,8660,0
835,9.72372,102,0,4,0,90.321,119,8189,4,0,314,4,17.705,4804,1622,8664,0
781,9.0951,72,0,11,0,81.638,163,8191,10,0,194,11,15.9578,4814,1633,8675,0
798,9.29368,72,0,148,0,74.217,73,8189,71,0,214,4,20.5121,4885,1637,8823,0
765,8.90929,66,0,4,0,72.109,93,8189,4,0,262,4,19.9064,4889,1641,8827,0
656,7.63973,46,0,132,0,44.655,46,8189,108,0,201,3,16.7265,4997,1644,8959,0
793,9.23531,58,0,1,0,85.919,89,8189,1,0,352,1,18.1476,4998,1645,8960,0
864,10.0618,150,0,2,0,146.977,164,8189,2,0,313,2,16.6683,5000,1647,8962,0
813,9.4678,122,0,8,0,107.855,198,8189,8,0,195,8,17.6351,5008,1655,8970,0
761,8.86287,81,0,10,0,110.348,211,8189,10,0,81,10,14.4552,5018,1665,8980,0
843,9.81673,68,0,9,0,90.188,233,8191,9,0,156,9,16.6799,5027,1674,8989,0
766,8.91991,160,0,22,0,88.372,242,8191,22,0,67,22,15.7132,5049,1696,9011,0
532,6.19488,60,0,253,0,81.208,121,8189,69,0,119,11,13.7912,5118,1707,9264,0
744,8.66387,111,0,7,0,95.985,123,8190,6,0,208,7,14.9327,5124,1714,9271,0
779,9.07171,108,0,14,0,86.977,126,8189,15,0,123,14,12.7313,5139,1728,9285,0
726,8.45432,134,0,4,0,87.236,134,8189,4,0,156,4,11.9625,5143,1732,9289,0
789,9.18786,90,0,5,0,97.816,169,8189,5,0,254,5,17.6001,5148,1737,9294,0
783,9.11817,97,0,4,0,111.071,213,8106,4,0,260,4,16.7032,5152,1741,9298,0
850,9.89889,110,0,5,0,96.003,240,8191,5,0,189,5,16.9362,5157,1746,9303,0
766,8.92021,105,0,13,0,89.045,262,8191,13,0,174,13,15.3171,5170,1759,9316,0
858,9.99263,90,0,14,0,116.597,278,8191,14,0,136,14,15.783,5184,1773,9330,0
780,9.08376,113,0,7,0,87.243,302,8190,7,0,218,7,17.4254,5191,1780,9337,0
890,10.3654,111,0,3,0,138.559,332,8189,3,0,300,3,15.0376,5194,1783,9340,0
824,9.59669,80,0,14,0,126.252,344,8189,14,0,124,14,11.4966,5208,1797,9354,0
765,8.90929,77,0,7,0,118.648,358,8187,7,0,158,7,11.7878,5215,1804,9361,0
827,9.63075,30,0,276,0,208.454,28,8191,83,0,149,9,15.8995,5298,1813,9637,0
731,8.51241,60,0,2,0,111.424,134,8191,11,0,259,2,16.2723,5309,1815,9639,0
748,8.71067,100,0,11,0,86.387,136,8190,11,0,123,11,16.412,5320,1826,9650,0
763,8.88517,123,0,1,0,121.069,149,8189,1,0,289,1,14.4552,5321,1827,9651,0
758,8.82694,137,0,11,0,119.697,158,8115,11,0,85,11,11.3452,5332,1838,9662,0
807,9.39733,66,0,8,0,153.623,178,8189,8,0,140,8,14.0475,5340,1846,9670,0
838,9.75837,118,0,5,0,108.592,208,8189,5,0,181,5,16.9362,5345,1851,9675,0
792,9.22301,115,0,15,0,103.021,216,8163,15,0,49,15,16.3538,5360,1866,9690,0
848,9.87526,223,0,43,0,81.79,223,8177,43,0,48,43,14.1756,5403,1909,9733,0
647,7.53455,105,0,233,0,96.316,111,8191,69,0,192,10,14.2921,5472,1919,9966,0
740,8.61757,89,0,7,0,99.242,115,8191,7,0,174,7,15.0259,5479,1926,9973,0
751,8.7459,126,0,4,0,126.523,126,8189,4,0,216,4,13.8262,5483,1930,9977,0
783,9.11836,140,0,13,0,86.511,140,8191,13,0,118,13,15.7481,5496,1943,9990,0
785,9.14199,90,0,9,0,102.349,177,8189,9,0,185,9,14.5134,5505,1952,9999,0
591,6.88292,189,0,10,0,146.216,189,8191,10,0,70,10,16.412,5515,1962,10009,0
520,6.0554,94,0,191,0,103.282,94,8148,61,0,167,2,16.6333,5576,1964,10200,0
605,7.04566,55,0,96,0,57.378,55,8191,62,0,207,2,15.9345,5638,1966,10296,0
637,7.4176,66,0,4,0,73,115,8191,4,0,231,4,15.7481,5642,1970,10300,0
823,9.58368,77,0,9,0,67.141,157,8191,9,0,178,9,17.2856,5651,1979,10309,0
755,8.79195,105,0,8,0,119.149,192,8189,8,0,195,8,17.5535,5659,1987,10317,0
770,8.96687,145,0,4,0,111.998,224,8189,4,0,206,4,15.387,5663,1991,10321,0
768,8.94414,69,0,232,0,66.182,80,8189,106,0,161,7,14.0125,5769,1998,10553,0
784,9.12991,107,0,9,0,83.449,113,8189,9,0,173,9,15.5268,5778,2007,10562,0
717,8.34994,118,0,7,0,93.674,118,8188,7,0,190,7,12.673,5785,2014,10569,0
752,8.75786,78,0,5,0,117.877,137,8189,5,0,224,5,13.3836,5790,2019,10574,0
776,9.03701,102,0,24,0,80.77,172,8190,24,0,197,16,11.2403,5814,2035,10598,0
775,9.02554,72,0,148,0,76.488,72,8189,82,0,243,9,15.4685,5896,2044,10746,0
897,10.447,123,0,12,0,85.797,136,8189,12,0,354,6,22.8534,5908,2050,10758,0
897,10.4469,104,0,1,0,81.655,215,8189,1,0,432,1,16.447,5909,2051,10759,0
902,10.5052,90,0,4,0,128.775,250,8189,4,0,254,4,17.6118,5913,2055,10763,0
836,9.73454,57,0,4,0,86.411,280,8189,4,0,248,4,18.2641,5917,2059,10767,0
977,11.3771,94,0,257,0,75.822,126,8190,257,0,249,4,19.5453,6174,2063,11024,0
659,7.67415,6,0,159,0,124.447,6,8090,147,0,95,14,16.61,6321,2077,11183,0
1019,11.8672,78,0,1,0,67.56,103,8189,1,0,446,1,19.7317,6322,2078,11184,0
987,11.4944,164,0,0,0,149.421,199,8189,0,0,455,0,24.4259,6322,2078,11184,0
975,11.3552,220,0,2,0,79.727,251,8190,2,0,363,2,23.4707,6324,2080,11186,0
903,10.5162,284,0,4,0,231.59,284,8190,4,0,282,4,14.4901,6328,2084,11190,0
895,10.423,92,0,2,0,72.546,315,8189,2,0,290,2,15.9578,6330,2086,11192,0
897,10.4463,182,0,1,0,119.998,343,8189,1,0,290,1,19.0911,6331,2087,11193,0
794,9.24639,95,0,7,0,83.471,363,8189,7,0,223,7,15.3637,6338,2094,11200,0
837,9.74692,139,0,5,0,111.642,393,8146,5,0,349,5,16.9478,6343,2099,11205,0
833,9.70174,141,0,6,0,232.422,405,8189,6,0,156,6,18.3223,6349,2105,11211,0
761,8.86257,114,0,20,0,96.646,410,8190,20,0,54,20,15.9694,6369,2125,11231,0
810,9.43363,76,0,13,0,84.157,419,8189,13,0,124,13,15.2006,6382,2138,11244,0
823,9.58424,42,0,361,0,86.662,3,7981,138,0,27,30,14.7697,6520,2168,11605,0
521,6.0673,70,0,43,0,66.317,73,8191,42,0,212,1,14.9677,6562,2169,11648,0
619,7.20816,135,0,9,0,122.916,135,8170,10,0,202,9,20.1161,6572,2178,11657,0
515,5.99695,68,0,136,0,76.945,68,8189,92,0,152,1,18.5436,6664,2179,11793,0
783,9.11791,87,0,1,0,104.807,115,8189,1,0,352,1,16.8663,6665,2180,11794,0
717,8.3497,123,0,3,0,131.429,163,8191,3,0,210,3,15.1773,6668,2183,11797,0
835,9.72451,129,0,4,0,127.317,199,8189,4,0,201,4,15.5384,6672,2187,11801,0
806,9.38677,60,0,7,0,205.827,216,8189,7,0,110,7,15.7015,6679,2194,11808,0
776,9.03658,173,0,5,0,106.599,244,8115,5,0,205,5,15.7714,6684,2199,11813,0
770,8.96668,135,0,23,0,149.723,259,8191,23,0,114,23,14.9211,6707,2222,11836,0
423,4.92609,69,0,271,0,52.534,76,8189,70,0,75,12,15.154,6777,2234,12107,0
816,9.50294,64,0,16,0,91.829,130,8191,16,0,186,16,16.0044,6793,2250,12123,0
844,9.82961,75,0,5,0,68.534,137,8189,4,0,288,5,17.5535,6797,2255,12128,0
460,5.35719,64,0,144,0,53.484,64,8189,67,0,68,7,20.3724,6864,2262,12272,0
706,8.22255,69,0,7,0,86.847,78,8189,7,0,250,7,16.7964,6871,2269,12279,0
748,8.71122,121,0,6,0,110.207,121,8189,6,0,219,6,14.7231,6877,2275,12285,0
754,8.7804,46,0,7,0,81.472,154,8189,7,0,141,7,15.7481,6884,2282,12292,0
773,9.00145,156,0,11,0,103.587,174,8151,11,0,104,11,17.7632,6895,2293,12303,0
461,5.36859,16,0,193,0,56.324,16,8189,100,0,51,12,18.2874,6995,2305,12496,0
591,6.88219,46,0,92,0,64.652,46,8189,71,0,213,2,15.8296,7066,2307,12588,0
680,7.91868,80,0,2,0,66.998,97,8189,2,0,263,2,14.7813,7068,2309,12590,0
745,8.67563,118,0,6,0,89.379,148,8190,6,0,197,6,14.7231,7074,2315,12596,0
759,8.8386,143,0,3,0,150.708,198,8190,3,0,268,3,13.6282,7077,2318,12599,0
724,8.43123,80,0,12,0,121.654,213,8189,12,0,98,12,16.4819,7089,2330,12611,0
885,10.3062,72,0,7,0,138.76,247,8189,6,0,247,7,17.6933,7095,2337,12618,0
872,10.1552,74,0,10,0,81,269,8191,11,0,173,10,15.7364,7106,2347,12628,0
822,9.57244,108,0,3,0,109.031,293,8189,3,0,210,3,15.4685,7109,2350,12631,0
776,9.03712,108,0,12,0,89.132,310,8189,12,0,168,12,15.8995,7121,2362,12643,0
792,9.22286,171,0,5,0,105.49,335,8159,5,0,253,5,15.2356,7126,2367,12648,0
794,9.24546,114,0,8,0,100.748,356,8191,8,0,222,8,11.7994,7134,2375,12656,0
738,8.5943,94,0,9,0,170.698,367,8191,9,0,122,9,17.2157,7143,2384,12665,0
808,9.40925,92,0,9,0,77.63,379,8189,9,0,139,9,16.5402,7152,2393,12674,0
763,8.88514,73,0,6,0,143.935,395,8189,6,0,198,6,16.7149,7158,2399,12680,0
773,9.00141,65,0,3,0,157.278,414,8189,3,0,238,3,12.4168,7161,2402,12683,0
704,8.19802,415,0,23,0,105.406,415,8170,23,0,19,23,12.8827,7184,2425,12706,0
512,5.96223,9,0,529,0,74.455,9,8189,173,0,117,2,15.2006,7357,2427,13235,0
736,8.57132,74,0,2,0,58.392,74,8189,2,0,308,2,14.956,7359,2429,13237,0
752,8.74804,74,0,4,0,78.324,138,8191,4,0,245,4,13.5,7363,2433,13241,0
821,9.56066,69,0,161,0,79.439,77,8191,97,0,155,7,13.3253,7460,2440,13402,0
704,8.19827,87,0,4,0,92.34,87,8189,4,0,271,4,13.0458,7464,2444,13406,0
752,8.75714,117,0,5,0,115.062,128,8190,5,0,229,5,12.0906,7469,2449,13411,0
776,9.03756,154,0,14,0,110.146,154,8190,14,0,114,14,14.9444,7483,2463,13425,0
823,9.58486,67,0,7,0,122.885,188,8189,7,0,184,7,15.6666,7490,2470,13432,0
805,9.37527,101,0,7,0,85.82,218,8121,7,0,192,7,15.6666,7497,2477,13439,0
807,9.3987,84,0,13,0,63.444,236,8189,13,0,125,13,15.7132,7510,2490,13452,0
745,8.67589,75,0,12,0,116.439,248,8189,12,0,95,12,13.8495,7522,2502,13464,0
863,10.0496,149,0,12,0,111.439,269,8189,12,0,169,12,14.56,7534,2514,13476,0
830,9.66554,141,0,6,0,118.043,284,8189,6,0,126,6,15.0958,7540,2520,13482,0
806,9.3865,126,0,6,0,197.858,304,8191,6,0,182,6,14.9793,7546,2526,13488,0
789,9.18742,153,0,3,0,82.293,319,8191,3,0,149,3,14.3037,7549,2529,13491,0
794,9.24515,78,0,7,0,77.633,338,8189,7,0,199,7,18.3223,7556,2536,13498,0
844,9.8283,142,0,4,0,100.891,361,8189,4,0,248,4,16.8547,7560,2540,13502,0
770,8.96667,78,0,7,0,103.575,378,8187,7,0,197,7,17.4487,7567,2547,13509,0
780,9.08342,75,0,6,0,143.638,395,8189,6,0,200,6,18.0777,7573,2553,13515,0
804,9.36296,73,0,7,0,157.379,406,8189,7,0,146,7,15.0259,7580,2560,13522,0
780,9.08339,91,0,5,0,151.664,423,8072,5,0,220,5,16.645,7585,2565,13527,0
813,9.46792,144,0,13,0,127.752,436,8160,13,0,177,13,14.8046,7598,2578,13540,0
798,9.29306,77,0,9,0,115.683,445,8191,9,0,114,9,14.0824,7607,2587,13549,0
778,9.0604,125,0,5,0,157.99,455,8191,5,0,151,5,13.7097,7612,2592,13554,0
810,9.43333,148,0,17,0,98.892,464,8189,17,0,119,17,12.8361,7629,2609,13571,0
790,9.20029,95,0,8,0,97.659,473,8037,8,0,133,8,14.6299,7637,2617,13579,0
833,9.70063,77,0,7,0,103.782,485,8189,7,0,186,7,15.189,7644,2624,13586,0
792,9.2231,90,0,7,0,143.433,497,8191,7,0,178,7,16.6566,7651,2631,13593,0
797,9.28117,78,0,10,0,150.231,505,8191,10,0,123,10,18.5436,7661,2641,13603,0
732,8.52411,173,0,1,0,112.9,523,8189,1,0,290,1,13.966,7662,2642,13604,0
776,9.03652,97,0,5,0,243.295,532,8189,5,0,158,5,14.4319,7667,2647,13609,0
790,9.19926,109,0,15,0,96.195,542,8166,15,0,159,15,14.6765,7682,2662,13624,0
955,11.1217,86,0,8,0,186.904,556,8191,8,0,246,8,15.8063,7690,2670,13632,0
813,9.46769,119,0,11,0,95.171,566,8191,11,0,178,11,16.5635,7701,2681,13643,0
819,9.5374,121,0,6,0,124.712,577,8189,6,0,200,6,13.5583,7707,2687,13649,0
790,9.19979,59,0,191,0,125.679,5,8190,23,0,171,7,16.2839,7730,2694,13840,0
675,7.86044,93,0,6,0,88.667,93,8189,53,0,182,6,11.6713,7783,2700,13846,0
663,7.72094,62,0,6,0,109.612,98,8191,6,0,173,6,14.56,7789,2706,13852,0
739,8.60621,90,0,4,0,89.455,122,8191,4,0,233,4,18.7533,7793,2710,13856,0
762,8.87387,108,0,6,0,151.049,172,8190,6,0,235,6,19.755,7799,2716,13862,0
823,9.58474,151,0,4,0,103.414,215,8189,4,0,260,4,16.4936,7803,2720,13866,0
874,10.1777,204,0,6,0,185.184,255,8189,6,0,293,6,19.6385,7809,2726,13872,0
734,8.54744,79,0,4,0,90.195,275,8189,4,0,169,4,17.3788,7813,2730,13876,0
798,9.29229,130,0,2,0,155.664,308,8191,2,0,299,2,14.8978,7815,2732,13878,0
820,9.54949,71,0,20,0,143.611,320,8189,20,0,113,20,15.8296,7835,2752,13898,0
467,5.43817,11,0,337,0,83.855,11,8189,76,0,17,17,15.1657,7911,2769,14235,0
814,9.47882,84,0,17,0,87.425,160,8189,17,0,156,17,12.1256,7928,2786,14252,0
835,9.72335,156,0,10,0,99.022,161,8189,10,0,170,10,16.214,7938,2796,14262,0
787,9.1647,63,0,6,0,112.782,163,8104,6,0,177,6,18.8581,7944,2802,14268,0
823,9.58409,142,0,11,0,92.706,168,8190,11,0,177,11,14.5134,7955,2813,14279,0
799,9.30427,100,0,5,0,112.247,183,8190,5,0,224,5,13.8378,7960,2818,14284,0
794,9.24657,68,0,7,0,89.208,202,8191,7,0,161,7,15.7015,7967,2825,14291,0
773,9.00236,75,0,5,0,92.34,229,8189,5,0,182,5,17.8214,7972,2830,14296,0
454,5.2873,24,0,241,0,59.093,24,8189,95,0,55,8,15.1773,8067,2838,14537,0
770,8.96766,115,0,5,0,107.961,117,8189,5,0,231,5,14.4785,8072,2843,14542,0
693,8.07064,117,0,4,0,92.317,121,8189,4,0,187,4,18.9746,8076,2847,14546,0
729,8.49002,60,0,5,0,102.372,141,8189,5,0,251,5,14.8861,8081,2852,14551,0
839,9.77009,107,0,6,0,100.022,182,8191,6,0,229,6,15.0492,8087,2858,14557,0
786,9.15321,91,0,3,0,120.144,227,8189,3,0,293,3,15.1773,8090,2861,14560,0
725,8.44331,146,0,8,0,88.827,245,8189,8,0,129,8,12.6497,8098,2869,14568,0
608,7.08036,39,0,307,0,40.763,39,8189,139,0,157,4,15.0609,8237,2873,14875,0
710,8.26829,101,0,2,0,116.399,101,8191,2,0,298,2,17.4604,8239,2875,14877,0
735,8.55937,72,0,4,0,80.727,147,8189,4,0,178,4,18.5553,8243,2879,14881,0
822,9.57271,155,0,6,0,156.662,193,8191,6,0,248,6,16.0276,8249,2885,14887,0
770,8.9671,72,0,7,0,89.319,212,8189,7,0,118,7,16.6333,8256,2892,14894,0
822,9.57276,112,0,11,0,103.934,234,8191,11,0,156,11,16.5984,8267,2903,14905,0
818,9.52623,114,0,6,0,94.762,261,8191,6,0,212,6,16.9245,8273,2909,14911,0
801,9.32801,87,0,3,0,109.362,292,8191,3,0,268,3,16.7731,8276,2912,14914,0
778,9.06032,143,0,16,0,116.952,306,8191,16,0,132,16,17.4254,8292,2928,14930,0
769,8.95604,138,0,7,0,128.018,326,8189,7,0,195,7,17.7399,8299,2935,14937,0
766,8.92046,109,0,7,0,123.425,343,8143,7,0,174,7,13.6748,8306,2942,14944,0
510,5.93875,54,0,350,0,35.482,54,8189,65,0,53,7,13.2904,8371,2949,15294,0
823,9.58393,134,0,5,0,88.164,171,8189,5,0,228,5,14.6532,8376,2954,15299,0
766,8.91997,68,0,9,0,89.699,173,8191,9,0,178,9,17.5302,8385,2963,15308,0
898,10.4568,58,0,178,0,101.974,89,8134,178,0,283,5,14.6066,8563,2968,15486,0
696,8.10548,97,0,4,0,95.288,111,8190,4,0,236,4,16.1558,8567,2972,15490,0
784,9.12973,138,0,13,0,91.141,146,8191,13,0,165,13,15.7597,8580,2985,15503,0
796,9.26962,67,0,8,0,121.867,184,8189,8,0,194,8,14.5134,8588,2993,15511,0
860,10.0157,207,0,3,0,133.212,213,8191,3,0,182,3,14.5251,8591,2996,15514,0
762,8.87428,156,0,16,0,174.876,231,8191,16,0,124,16,14.5367,8607,3012,15530,0
824,9.59601,92,0,10,0,80.009,252,8189,10,0,156,10,14.5833,8617,3022,15540,0
803,9.35176,96,0,12,0,97.569,267,8191,12,0,128,12,15.8296,8629,3034,15552,0
766,8.92003,120,0,12,0,225.086,276,8189,12,0,75,12,16.412,8641,3046,15564,0
750,8.73451,111,0,7,0,104.227,300,8124,7,0,212,7,14.9444,8648,3053,15571,0
875,10.1904,140,0,7,0,118.08,322,8151,7,0,221,7,16.7731,8655,3060,15578,0
713,8.30335,114,0,324,0,98.934,134,8153,95,0,132,3,16.5052,8750,3063,15902,0
767,8.932,130,0,5,0,79.788,161,8189,5,0,200,5,15.62,8755,3068,15907,0
788,9.17649,42,0,165,0,91.568,45,8191,123,0,189,3,16.5285,8878,3071,16072,0
503,5.85763,42,0,82,0,73.893,42,8191,71,0,182,1,13.9077,8949,3072,16154,0
774,9.01354,92,0,2,0,108.953,124,8191,2,0,332,2,13.6864,8951,3074,16156,0
754,8.78128,110,0,5,0,93.945,174,8189,5,0,234,5,15.6666,8956,3079,16161,0
789,9.17901,83,0,7,0,86.382,206,8189,7,0,189,7,14.2572,8963,3086,16168,0
803,9.35194,120,0,9,0,86.172,236,8169,9,0,205,9,16.4004,8972,3095,16177,0
655,7.62817,245,0,17,0,112.712,245,8163,17,0,74,17,16.3538,8989,3112,16194,0
674,7.84905,122,0,254,0,82.751,122,8163,101,0,143,9,14.4785,9090,3121,16448,0
785,9.14221,86,0,8,0,128.301,123,8189,8,0,160,8,13.7446,9098,3129,16456,0
816,9.50369,125,0,1,0,117.974,137,8191,1,0,332,1,13.931,9099,3130,16457,0
756,8.80429,62,0,12,0,108.789,151,8189,12,0,128,12,14.8745,9111,3142,16469,0
776,9.03768,79,0,14,0,126.846,172,8190,14,0,110,14,15.8063,9125,3156,16483,0
815,9.49184,154,0,11,0,138.127,200,8170,11,0,165,11,19.8249,9136,3167,16494,0
315,3.66863,49,0,205,0,89.285,84,8189,63,0,82,5,20.1976,9199,3172,16699,0
807,9.39722,59,0,6,0,117.552,104,8189,6,0,267,6,19.6851,9205,3178,16705,0
669,7.79081,118,0,4,0,127.854,119,8189,4,0,203,4,15.4569,9209,3182,16709,0
751,8.74537,87,0,6,0,69.747,161,8185,6,0,230,6,15.2705,9215,3188,16715,0
764,8.89695,123,0,4,0,193.325,189,8189,4,0,154,4,15.7947,9219,3192,16719,0
855,9.9564,207,0,4,0,103.823,227,8191,4,0,247,4,19.1726,9223,3196,16723,0
749,8.72231,164,0,8,0,80.491,249,8189,8,0,168,8,17.5419,9231,3204,16731,0
780,9.08341,105,0,10,0,112.887,263,8152,10,0,110,10,18.9513,9241,3214,16741,0
798,9.29312,72,0,8,0,239.31,281,8185,8,0,155,8,12.4401,9249,3222,16749,0
833,9.70064,110,0,7,0,112.572,307,8156,7,0,237,7,12.1372,9256,3229,16756,0
855,9.95734,116,0,23,0,102.819,315,8188,22,0,81,23,12.9293,9278,3252,16779,0
844,9.82875,167,0,9,0,93.774,326,8189,10,0,112,9,16.0975,9288,3261,16788,0
795,9.25831,119,0,3,0,126.608,349,8189,3,0,242,3,12.9176,9291,3264,16791,0
837,9.74781,79,0,11,0,101.188,360,8191,11,0,113,11,11.8227,9302,3275,16802,0
805,9.37489,74,0,13,0,93.664,366,8189,13,0,78,13,14.5251,9315,3288,16815,0
758,8.828,129,0,7,0,89.059,378,8189,7,0,133,7,14.9327,9322,3295,16822,0
831,9.67718,145,0,9,0,103.081,390,8139,9,0,143,9,14.9677,9331,3304,16831,0
815,9.49066,80,0,14,0,117.311,402,8191,14,0,156,14,14.56,9345,3318,16845,0
805,9.37463,87,0,10,0,78.315,418,8191,10,0,205,10,17.0993,9355,3328,16855,0
781,9.0946,189,0,13,0,93.942,425,8191,13,0,85,13,16.8197,9368,3341,16868,0
705,8.20953,60,0,284,0,129.717,140,8189,111,0,170,5,15.0725,9479,3346,17152,0
504,5.86908,18,0,155,0,50.054,18,8189,75,0,64,15,14.2572,9554,3361,17307,0
713,8.30294,72,0,5,0,76.76,74,8189,5,0,229,5,12.6381,9559,3366,17312,0
742,8.6407,105,0,7,0,87.748,105,8190,7,0,235,7,13.8728,9566,3373,17319,0
800,9.31656,76,0,4,0,106.28,155,8189,4,0,202,4,15.2239,9570,3377,17323,0
810,9.43266,94,0,5,0,113.609,199,8189,5,0,243,5,12.0324,9575,3382,17328,0
534,6.21839,9,0,212,0,76.887,9,8191,67,0,42,8,12.7895,9642,3390,17540,0
699,8.1403,104,0,6,0,101.339,104,8191,6,0,254,6,14.6415,9648,3396,17546,0
844,9.8286,103,0,4,0,86.985,118,8189,4,0,279,4,14.6881,9652,3400,17550,0
808,9.40886,71,0,8,0,80.253,153,8191,8,0,208,8,17.5652,9660,3408,17558,0
795,9.2585,63,0,8,0,101.919,190,8189,8,0,200,8,16.2257,9668,3416,17566,0
755,8.79233,95,0,14,0,103.908,216,8189,14,0,166,14,13.6165,9682,3430,17580,0
861,10.0267,84,0,11,0,100.784,229,8189,11,0,89,11,18.6252,9693,3441,17591,0
714,8.3152,122,0,8,0,104.4,252,8189,8,0,170,8,16.1791,9701,3449,17599,0
808,9.40927,77,0,4,0,95.681,284,8189,4,0,267,4,18.9396,9705,3453,17603,0
786,9.15297,152,0,5,0,164.886,301,8189,5,0,158,5,16.3421,9710,3458,17608,0
764,8.89679,118,0,1,0,91.838,331,8191,1,0,296,1,14.9327,9711,3459,17609,0
823,9.58439,175,0,20,0,103.627,338,8171,20,0,77,20,14.8745,9731,3479,17629,0
884,10.2944,216,0,11,0,125.261,359,8170,11,0,223,11,14.5367,9742,3490,17640,0
832,9.68949,221,0,10,0,84.8,367,8142,10,0,92,10,14.8512,9752,3500,17650,0
809,9.42102,122,0,13,0,155.135,377,8162,13,0,121,13,16.5169,9765,3513,17663,0
666,7.75597,379,0,44,0,96.011,379,8175,44,0,18,43,13.6165,9809,3556,17707,0
484,5.63657,107,0,386,0,73.448,107,8191,159,0,105,7,13.2671,9968,3563,18093,0
657,7.65124,62,0,110,0,83.682,63,8189,61,0,245,3,17.1226,10029,3566,18203,0
763,8.886,73,0,8,0,107.895,121,8189,8,0,238,8,13.4301,10037,3574,18211,0
771,8.97817,72,0,7,0,110.826,162,8189,7,0,183,7,15.7015,10044,3581,18218,0
680,7.91895,63,0,130,0,48.756,63,8189,56,0,199,3,13.8495,10100,3584,18348,0
737,8.5827,57,0,3,0,81.584,78,8189,3,0,277,3,16.9711,10103,3587,18351,0
738,8.59446,95,0,4,0,146.006,137,8189,4,0,246,4,16.61,10107,3591,18355,0
796,9.27061,46,0,161,0,75.282,46,8189,58,0,314,4,20.1044,10165,3595,18516,0
643,7.48774,66,0,47,0,71.922,93,8191,47,0,274,1,16.1092,10212,3596,18563,0
727,8.46652,75,0,7,0,73.978,141,8189,7,0,175,7,15.189,10219,3603,18570,0
755,8.79229,110,0,11,0,82.599,166,8191,11,0,120,11,14.758,10230,3614,18581,0
696,8.10551,56,0,132,0,74.079,68,8191,70,0,215,2,14.5367,10300,3616,18713,0
768,8.9442,96,0,2,0,95.236,111,8189,2,0,286,2,11.8227,10302,3618,18715,0
783,9.11865,163,0,4,0,94.468,167,8190,4,0,243,4,16.7265,10306,3622,18719,0
734,8.54807,85,0,9,0,89.833,197,8189,9,0,173,9,16.3654,10315,3631,18728,0
768,8.94386,202,0,44,0,85.222,202,8182,44,0,31,44,14.1873,10359,3675,18772,0
491,5.71813,100,0,204,0,128.503,101,8191,129,0,136,2,13.9892,10488,3677,18976,0
720,8.38502,99,0,3,0,81.736,107,8191,3,0,272,3,14.5251,10491,3680,18979,0
743,8.6533,102,0,6,0,86.68,126,8191,6,0,193,6,14.1989,10497,3686,18985,0
776,9.03634,103,0,3,0,114.54,175,8189,3,0,260,3,16.0626,10500,3689,18988,0
742,8.64045,4,0,197,0,84.727,4,8191,91,0,198,7,17.1459,10591,3696,19185,0
717,8.34956,96,0,3,0,91.555,96,8189,3,0,231,3,14.2106,10594,3699,19188,0
833,9.70016,54,0,2,0,68.398,122,8191,2,0,355,2,17.868,10596,3701,19190,0
810,9.43229,133,0,6,0,124.852,154,8190,6,0,150,6,16.7615,10602,3707,19196,0
500,5.82261,74,0,159,0,74.132,77,8189,93,0,123,5,12.2886,10695,3712,19355,0
766,8.92061,87,0,5,0,78.988,90,8189,5,0,265,5,12.2537,10700,3717,19360,0
765,8.90896,128,0,6,0,97.258,128,8190,6,0,195,6,16.0509,10706,3723,19366,0
805,9.37487,66,0,4,0,101.13,184,8189,4,0,276,4,17.1226,10710,3727,19370,0
798,9.29336,100,0,4,0,80.632,218,8191,4,0,215,4,13.733,10714,3731,19374,0
978,11.39,225,0,3,0,201.396,259,8189,3,0,307,3,13.9543,10717,3734,19377,0
806,9.38695,102,0,2,0,78.906,305,8189,2,0,404,2,14.2572,10719,3736,19379,0
804,9.36319,224,0,5,0,102.37,323,8189,5,0,173,5,14.9211,10724,3741,19384,0
826,9.61943,114,0,5,0,87.736,350,8190,5,0,288,5,14.0708,10729,3746,19389,0
788,9.17717,176,0,8,0,89.529,363,8191,8,0,138,8,14.0125,10737,3754,19397,0
691,8.04627,69,0,212,0,82.665,103,8189,121,0,195,5,19.4988,10858,3759,19609,0
684,7.96456,102,0,5,0,97.768,110,8189,5,0,225,5,16.878,10863,3764,19614,0
787,9.16485,142,0,5,0,82.573,142,8139,5,0,279,5,16.1558,10868,3769,19619,0
811,9.44388,146,0,8,0,72.169,173,8189,8,0,155,8,16.8197,10876,3777,19627,0
667,7.76748,87,0,177,0,100.028,87,8189,105,0,209,4,17.7632,10981,3781,19804,0
700,8.15144,86,0,4,0,116.428,99,8189,4,0,219,4,17.472,10985,3785,19808,0


