SendPacket,SendRate(Mb/s),FlightSize,ReceiveRate(Mb/s),Send Loss,Recv Loss,RTT(ms),CWnd,FlowWindow,Retrans,PktSndPeriod(us),RecvACK,RecvNAK,EstimatedBandwidth(Mb/s),Retrans_Total,NAK_TotalRecv,Total Send Loss,Total Recv Loss
821,2.79083,179,0,5,0,118.792,208,8190,5,0,206,5,3.48019,5,5,5,0
1043,3.80376,205,0,43,0,103.862,246,8172,43,0,38,43,4.58189,48,48,48,0
588,2.1444,73,0,267,0,34.841,73,8189,264,0,75,17,4.86643,312,65,315,0
924,3.36987,110,0,8,0,97.114,126,8189,8,0,275,8,6.84365,320,73,323,0
907,3.3079,103,0,12,0,102.929,127,8157,12,0,156,12,6.8473,332,85,335,0
803,2.9277,129,0,7,0,99.918,129,8189,7,0,208,7,5.35526,339,92,342,0
850,3.09988,102,0,7,0,135.319,131,8189,7,0,188,7,5.29325,346,99,349,0
871,3.17581,124,0,6,0,122.277,132,8189,6,0,233,6,5.43187,352,105,355,0
898,3.27524,134,0,6,0,103.271,134,8190,6,0,264,6,5.93165,358,111,361,0
851,3.1036,134,0,9,0,130.87,136,8189,9,0,172,9,5.2896,367,120,370,0
861,3.14003,137,0,6,0,116.497,137,8190,6,0,237,6,5.63616,373,126,376,0
877,3.19833,138,0,9,0,105.448,138,8190,9,0,162,9,5.50118,382,135,385,0
859,3.13291,104,0,8,0,121.916,140,8098,8,0,177,8,4.88467,390,143,393,0
862,3.14369,134,0,9,0,112.7,141,8189,9,0,211,9,4.86643,399,152,402,0
804,2.93215,142,0,9,0,105.752,143,8191,9,0,190,9,8.03654,408,161,411,0
925,3.37344,139,0,7,0,145.674,144,8187,7,0,257,7,5.42458,415,168,418,0
919,3.35139,115,0,9,0,129.867,146,8189,9,0,192,9,5.49754,424,177,427,0
904,3.29692,121,0,8,0,116.923,147,8189,8,0,232,8,4.60378,432,185,435,0
855,3.11835,121,0,13,0,113.479,148,8126,13,0,168,13,5.69453,445,198,448,0
981,3.57771,149,0,23,0,89.822,149,8191,23,0,46,23,5.91706,468,221,471,0
859,3.13296,130,0,8,0,110.599,150,8191,8,0,151,8,6.08486,476,229,479,0
757,2.76013,151,0,158,0,114.283,2,8191,111,0,137,7,6.34387,587,236,637,0
689,2.5129,77,0,2,0,81.811,77,8189,49,0,252,2,4.85914,636,238,639,0
604,2.20267,43,0,78,0,58.67,43,8189,78,0,254,1,5.35526,714,239,717,0
837,3.05246,51,0,1,0,58.889,51,8140,1,0,398,1,4.61107,715,240,718,0
747,2.72431,57,0,2,0,61.842,57,8143,2,0,326,2,4.61837,717,242,720,0
499,1.81985,6,0,65,0,47.873,6,8191,65,0,190,2,4.84819,782,244,785,0
371,1.353,20,0,0,0,26.738,20,8189,0,0,189,0,5.73466,782,244,785,0
748,2.72765,34,0,0,0,32.895,34,8190,0,0,373,0,4.51622,782,244,785,0
736,2.68412,43,0,0,0,43.996,43,8189,0,0,369,0,4.62202,782,244,785,0
828,3.01954,51,0,1,0,52.31,51,8189,1,0,393,1,4.43232,783,245,786,0
795,2.89923,58,0,2,0,72.608,58,8189,2,0,348,2,5.21664,785,247,788,0
849,3.09621,64,0,2,0,74.975,64,8189,2,0,372,2,5.86598,787,249,790,0
807,2.94304,68,0,6,0,64.204,68,8126,6,0,281,6,5.43552,793,255,796,0
888,3.23856,73,0,2,0,75.433,73,8189,2,0,378,2,5.32608,795,257,798,0
799,2.914,77,0,4,0,60.212,77,8189,4,0,260,4,5.73101,799,261,802,0
877,3.19845,81,0,5,0,72.04,81,8189,5,0,326,5,6.57005,804,266,807,0
835,3.04524,84,0,5,0,74.531,84,8189,5,0,261,5,5.44646,809,271,812,0
737,2.68787,5,0,90,0,85.663,8,8189,72,0,217,4,6.18336,881,275,902,0
875,3.19099,51,0,0,0,63.557,51,8189,0,0,420,0,4.53811,881,275,902,0
813,2.96498,57,0,2,0,59.397,57,8189,2,0,357,2,4.14413,883,277,904,0
796,2.90295,63,0,4,0,64.767,63,8190,4,0,318,4,4.95034,887,281,908,0
879,3.20587,68,0,2,0,70.737,68,8189,2,0,352,2,4.14413,889,283,910,0
887,3.2349,73,0,6,0,64.977,73,8189,6,0,340,6,5.82221,895,289,916,0
859,3.13269,76,0,6,0,75.514,76,8189,6,0,287,6,4.8336,901,295,922,0
769,2.80447,43,0,79,0,42.855,43,8189,79,0,331,1,4.06022,980,296,1001,0
826,3.01113,51,0,1,0,48.352,51,8189,1,0,392,1,5.13638,981,297,1002,0
817,2.97972,58,0,3,0,58.789,58,8189,3,0,357,3,4.16237,984,300,1005,0
798,2.91045,63,0,2,0,67.639,63,8190,2,0,345,2,4.39584,986,302,1007,0
808,2.94674,67,0,5,0,66.287,67,8187,5,0,254,5,4.7424,991,307,1012,0
819,2.98682,72,0,3,0,67.354,72,8190,3,0,344,3,4.7351,994,310,1015,0
811,2.95761,76,0,3,0,75.586,76,8189,3,0,265,3,4.78618,997,313,1018,0
827,3.0159,80,0,3,0,83.846,80,8190,3,0,343,3,6.14688,1000,316,1021,0
688,2.50903,45,0,80,0,48.447,45,8189,80,0,290,0,5.93894,1080,316,1101,0
871,3.17646,54,0,0,0,51.018,54,8189,0,0,437,0,4.88467,1080,316,1101,0
819,2.98701,60,0,3,0,68.889,60,8189,3,0,355,3,4.49798,1083,319,1104,0
775,2.82654,65,0,4,0,70.824,65,8189,4,0,276,4,5.0999,1087,323,1108,0
862,3.14308,70,0,3,0,62.587,70,8189,3,0,332,3,5.70182,1090,326,1111,0
901,3.28582,75,0,3,0,79.83,75,8189,3,0,383,3,4.78618,1093,329,1114,0
867,3.16118,76,0,7,0,81.998,79,8189,7,0,324,7,5.18746,1100,336,1121,0
790,2.88114,82,0,5,0,76.709,82,8111,5,0,242,5,5.49024,1105,341,1126,0
752,2.74262,85,0,6,0,97.117,85,8189,6,0,257,6,3.77203,1111,347,1132,0
754,2.74986,47,0,87,0,46.892,47,8189,87,0,316,1,5.78208,1198,348,1219,0
751,2.7388,14,0,55,0,62.859,14,8189,55,0,346,1,5.74925,1253,349,1274,0
792,2.8884,38,0,0,0,45.013,38,8185,0,0,387,0,6.60653,1253,349,1274,0
851,3.10376,48,0,0,0,47.672,48,8189,0,0,425,0,5.22029,1253,349,1274,0
785,2.863,55,0,1,0,69.081,55,8189,1,0,370,1,5.016,1254,350,1275,0
797,2.90662,61,0,2,0,55.746,61,8189,2,0,346,2,12.6622,1256,352,1277,0
740,2.69879,65,0,5,0,70.262,65,8189,5,0,251,5,5.14003,1261,357,1282,0
755,2.75343,70,0,1,0,85.491,70,8189,1,0,348,1,5.32973,1262,358,1283,0
838,3.05605,19,0,78,0,86.859,3,8136,78,0,321,4,5.54496,1340,362,1361,0
666,2.42886,44,0,0,0,52.517,44,8189,0,0,318,0,6.2928,1340,362,1361,0
785,2.86281,52,0,0,0,57.382,52,8189,0,0,394,0,6.29645,1340,362,1361,0
808,2.94661,58,0,3,0,64.201,58,8189,3,0,329,3,4.61107,1343,365,1364,0
794,2.89571,63,0,4,0,74.235,63,8189,4,0,310,4,4.36666,1347,369,1368,0
861,3.14027,67,0,1,0,83.266,69,8189,1,0,401,1,4.0201,1348,370,1369,0
835,3.04535,73,0,5,0,87.53,73,8189,5,0,319,5,5.72006,1353,375,1374,0
845,3.08176,77,0,4,0,54.874,77,8189,4,0,287,4,6.1104,1357,379,1378,0
702,2.56025,39,0,83,0,58.53,39,8189,83,0,257,4,5.70182,1440,383,1461,0
748,2.72803,48,0,0,0,63.038,48,8189,0,0,374,0,5.62886,1440,383,1461,0
887,3.23481,54,0,0,0,59.722,56,8189,0,0,446,0,4.78253,1440,383,1461,0
835,3.04525,63,0,2,0,63.385,63,8189,2,0,369,2,4.95398,1442,385,1463,0
834,3.04158,68,0,4,0,67.373,68,8189,4,0,331,4,5.84774,1446,389,1467,0
686,2.50176,39,0,69,0,37.054,39,8189,69,0,293,1,7.35437,1515,390,1536,0
760,2.77165,48,0,0,0,63.056,48,8189,0,0,381,0,7.1136,1515,390,1536,0
799,2.91408,55,0,2,0,48.378,55,8189,2,0,351,2,5.23488,1517,392,1538,0
797,2.90677,60,0,4,0,55.268,60,8189,4,0,296,4,5.94989,1521,396,1542,0
786,2.86651,65,0,3,0,53.467,65,8189,3,0,307,3,6.50074,1524,399,1545,0
568,2.07136,16,0,70,0,76.883,16,8189,70,0,216,2,6.34022,1594,401,1615,0
671,2.44708,42,0,0,0,43.328,42,8189,0,0,331,0,5.6544,1594,401,1615,0
744,2.71328,50,0,0,0,58.896,50,8189,0,0,376,0,5.34432,1594,401,1615,0
727,2.65131,56,0,2,0,74,56,8189,2,0,317,2,4.45421,1596,403,1617,0
568,2.0715,32,0,59,0,37.086,32,8189,59,0,245,1,3.50573,1655,404,1676,0
796,2.90288,42,0,0,0,52.547,42,8189,0,0,400,0,5.36621,1655,404,1676,0
879,3.20593,52,0,0,0,53.632,52,8189,0,0,439,0,4.90656,1655,404,1676,0
784,2.85924,57,0,4,0,65.715,57,8189,4,0,292,4,5.33702,1659,408,1680,0
859,3.1327,64,0,0,0,64.748,64,8189,0,0,431,0,5.00506,1659,408,1680,0
859,3.1327,69,0,3,0,68.381,69,8187,3,0,332,3,6.45696,1662,411,1683,0
790,2.88106,73,0,6,0,70.351,73,8189,6,0,260,6,4.62566,1668,417,1689,0
866,3.15796,77,0,4,0,71.879,77,8189,4,0,361,4,5.08166,1672,421,1693,0
678,2.47262,44,0,79,0,47.196,44,8189,79,0,289,1,5.69453,1751,422,1772,0
730,2.66216,51,0,1,0,54.558,51,8189,1,0,343,1,5.34067,1752,423,1773,0
743,2.70964,57,0,2,0,63.476,57,8189,2,0,321,2,4.64755,1754,425,1775,0
835,3.04538,63,0,2,0,66.755,63,8189,2,0,373,2,4.63296,1756,427,1777,0
787,2.87033,67,0,3,0,54.357,68,8189,3,0,301,3,5.48294,1759,430,1780,0
652,2.37787,36,0,74,0,45.249,36,8189,74,0,213,4,7.06253,1833,434,1854,0
829,3.02356,46,0,0,0,47.866,46,8189,0,0,417,0,5.50848,1833,434,1854,0
781,2.84824,53,0,1,0,52.555,53,8189,1,0,371,1,4.8263,1834,435,1855,0
848,3.09246,60,0,2,0,61.262,60,8189,2,0,371,2,4.41408,1836,437,1857,0
697,2.54045,16,0,66,0,69.916,16,8189,66,0,285,2,6.33293,1902,439,1923,0
508,1.85262,9,0,55,0,112.634,9,8189,55,0,234,0,6.19795,1957,439,1978,0
392,1.42959,21,0,0,0,37.39,21,8189,0,0,197,0,5.97907,1957,439,1978,0
710,2.58871,34,0,0,0,37.924,34,8189,0,0,356,0,5.26771,1957,439,1978,0
767,2.79712,44,0,0,0,37.742,44,8189,0,0,383,0,4.0055,1957,439,1978,0
643,2.34502,51,0,0,0,53.689,51,8189,0,0,324,0,5.15098,1957,439,1978,0
677,2.469,56,0,1,0,54.282,56,8189,1,0,315,1,4.61472,1958,440,1979,0
831,3.03054,63,0,1,0,69.676,63,8189,1,0,389,1,4.70592,1959,441,1980,0
808,2.9467,68,0,3,0,67.426,68,8189,3,0,342,3,4.81171,1962,444,1983,0
812,2.96129,73,0,3,0,75.887,73,8190,3,0,341,3,5.46106,1965,447,1986,0
776,2.82987,77,0,4,0,79.776,77,8190,4,0,316,4,5.63251,1969,451,1990,0
820,2.99052,81,0,4,0,84.229,81,8189,4,0,299,4,4.53811,1973,455,1994,0
805,2.93575,85,0,4,0,90.913,85,8189,4,0,326,4,6.16877,1977,459,1998,0
811,2.95775,72,0,92,0,81.415,10,8189,92,0,243,5,5.01235,2069,464,2090,0
728,2.65491,50,0,0,0,48.752,50,8191,0,0,380,0,5.00141,2069,464,2090,0
778,2.83727,57,0,0,0,69.884,57,8189,0,0,391,0,5.81126,2069,464,2090,0
599,2.18446,31,0,62,0,42.632,31,8189,62,0,233,2,5.55955,2131,466,2152,0
634,2.31231,40,0,0,0,58.946,40,8189,0,0,321,0,5.69088,2131,466,2152,0
864,3.15116,49,0,0,0,53.077,49,8189,0,0,431,0,5.26771,2131,466,2152,0
786,2.86666,57,0,0,0,73.528,57,8189,0,0,395,0,4.8409,2131,466,2152,0
849,3.09589,64,0,0,0,60.774,64,8189,0,0,425,0,4.37395,2131,466,2152,0
817,2.97953,69,0,2,0,77.1,69,8189,2,0,347,2,6.13958,2133,468,2154,0
682,2.48732,72,0,5,0,67.635,72,8189,5,0,238,5,4.86278,2138,473,2159,0
692,2.52389,77,0,1,0,113.044,77,8189,1,0,317,1,4.57094,2139,474,2160,0
765,2.79004,80,0,2,0,85.497,80,8189,2,0,312,2,6.40224,2141,476,2162,0
742,2.70588,84,0,3,0,108.065,84,8189,3,0,256,3,6.36941,2144,479,2165,0
824,3.00503,88,0,1,0,90.55,88,8189,1,0,377,1,5.3881,2145,480,2166,0
723,2.63674,91,0,4,0,86.398,91,8189,4,0,235,4,5.22394,2149,484,2170,0
818,2.98303,94,0,7,0,109.765,94,8189,7,0,275,7,5.76749,2156,491,2177,0
860,3.13656,97,0,3,0,95.687,97,8189,3,0,298,3,6.09581,2159,494,2180,0
793,2.89228,97,0,7,0,88.847,99,8189,7,0,256,7,5.5559,2166,501,2187,0
829,3.02338,102,0,3,0,96.507,102,8189,3,0,320,3,5.39539,2169,504,2190,0
822,2.99786,105,0,4,0,102.409,105,8189,4,0,313,4,7.46381,2173,508,2194,0
815,2.97239,108,0,8,0,107.68,108,8189,8,0,254,8,4.99411,2181,516,2202,0
815,2.97243,110,0,8,0,119.692,110,8153,8,0,233,8,6.08486,2189,524,2210,0
892,3.25329,83,0,7,0,96.267,112,8189,7,0,266,7,5.54496,2196,531,2217,0
752,2.74248,115,0,9,0,122.466,115,8189,9,0,250,9,5.8368,2205,540,2226,0
710,2.58932,116,0,6,0,116.083,116,8190,6,0,188,6,6.27821,2211,546,2232,0
909,3.31507,115,0,3,0,112.451,119,8189,3,0,297,3,6.32928,2214,549,2235,0
728,2.65502,108,0,9,0,118.758,120,8190,9,0,143,9,6.3001,2223,558,2244,0
878,3.20196,120,0,4,0,101.927,122,8189,4,0,202,4,4.99776,2227,562,2248,0
756,2.75707,123,0,5,0,130.215,123,8191,5,0,200,5,3.80851,2232,567,2253,0
802,2.92484,125,0,5,0,123.951,125,8189,5,0,249,5,4.78618,2237,572,2258,0
777,2.83368,127,0,3,0,117.746,127,8189,3,0,204,3,4.89562,2240,575,2261,0
769,2.80448,129,0,7,0,103.311,129,8190,7,0,263,7,4.00915,2247,582,2268,0
534,1.94748,27,0,132,0,74.764,27,8191,108,0,94,3,4.96493,2355,585,2400,0
771,2.81155,68,0,2,0,79.838,68,8191,2,0,340,2,5.62522,2357,587,2402,0
704,2.56757,71,0,4,0,90.626,71,8191,4,0,225,4,6.00096,2361,591,2406,0
680,2.48012,41,0,71,0,49.794,41,8191,71,0,291,0,4.72781,2432,591,2477,0
857,3.12564,50,0,0,0,56.31,50,8191,0,0,429,0,4.98682,2432,591,2477,0
719,2.6222,56,0,2,0,63.79,56,8189,2,0,314,2,5.9353,2434,593,2479,0
847,3.08909,62,0,2,0,64.999,62,8189,2,0,367,2,6.31469,2436,595,2481,0
770,2.80811,67,0,3,0,69.386,67,8189,3,0,294,3,5.94624,2439,598,2484,0
552,2.01309,38,0,68,0,37.354,38,8189,68,0,230,1,5.09261,2507,599,2552,0
734,2.67704,46,0,0,0,51.797,46,8189,0,0,368,0,5.83315,2507,599,2552,0
767,2.79724,53,0,1,0,49.313,53,8189,1,0,359,1,5.4647,2508,600,2553,0
592,2.15917,59,0,0,0,58.445,59,8189,0,0,300,0,4.78253,2508,600,2553,0
803,2.92855,64,0,3,0,62.154,64,8189,3,0,319,3,5.5632,2511,603,2556,0
842,3.07067,70,0,1,0,73.439,70,8189,1,0,395,1,5.25677,2512,604,2557,0
653,2.38143,73,0,6,0,75.222,73,8189,6,0,232,6,5.85504,2518,610,2563,0
642,2.34138,42,0,73,0,37.759,42,8191,73,0,269,0,6.3913,2591,610,2636,0
756,2.75706,50,0,0,0,55.456,50,8189,0,0,382,0,5.27136,2591,610,2636,0
624,2.27581,56,0,0,0,68.72,56,8189,0,0,313,0,6.0265,2591,610,2636,0
921,3.35901,63,0,1,0,51.887,63,8189,1,0,435,1,5.66534,2592,611,2637,0
730,2.66214,3,0,72,0,67.21,3,8125,72,0,241,5,4.89197,2664,616,2709,0
576,2.10065,39,0,0,0,47,39,8189,0,0,277,0,5.32608,2664,616,2709,0
818,2.9832,49,0,0,0,54.353,49,8189,0,0,411,0,4.4761,2664,616,2709,0
776,2.82998,55,0,3,0,55.213,55,8185,3,0,319,3,5.50483,2667,619,2712,0
708,2.58204,60,0,1,0,64.213,60,8131,1,0,327,1,6.24538,2668,620,2713,0
828,3.01965,65,0,3,0,74.534,65,8127,3,0,324,3,6.77434,2671,623,2716,0
590,2.15161,35,0,69,0,81.922,35,8189,69,0,223,2,5.46835,2740,625,2785,0
587,2.14077,42,0,0,0,103.069,42,8187,0,0,295,0,4.32653,2740,625,2785,0
812,2.96136,51,0,0,0,54.921,51,8189,0,0,408,0,3.67354,2740,625,2785,0
758,2.76457,55,0,1,0,66.501,58,8189,1,0,353,1,4.03469,2741,626,2786,0
792,2.88829,63,0,3,0,72.645,63,8171,3,0,312,3,6.37306,2744,629,2789,0
785,2.86274,69,0,0,0,107.261,69,8189,0,0,397,0,6.64301,2744,629,2789,0
732,2.66959,5,0,76,0,85.76,5,8190,76,0,297,3,4.47245,2820,632,2865,0
702,2.56024,43,0,0,0,41.94,43,8189,0,0,337,0,4.22803,2820,632,2865,0
800,2.91774,51,0,1,0,59.534,51,8189,1,0,379,1,5.0087,2821,633,2866,0
792,2.88848,57,0,2,0,65.341,57,8189,2,0,347,2,5.26771,2823,635,2868,0
545,1.98756,31,0,62,0,41.327,31,8191,62,0,205,2,5.0087,2885,637,2930,0
530,1.93286,38,0,0,0,63.178,38,8189,0,0,267,0,5.27501,2885,637,2930,0
756,2.75702,39,0,0,0,48.52,47,8189,0,0,381,0,4.56365,2885,637,2930,0
767,2.79731,55,0,1,0,66.735,55,8189,1,0,382,1,4.0055,2886,638,2931,0
508,1.85264,33,0,55,0,54.106,33,8189,55,0,218,0,5.12909,2941,638,2986,0
701,2.55652,42,0,0,0,53.436,42,8189,0,0,350,0,4.25722,2941,638,2986,0
792,2.88839,51,0,0,0,63.121,51,8187,0,0,396,0,6.31469,2941,638,2986,0
787,2.87022,57,0,2,0,73.186,57,8190,2,0,369,2,6.32198,2943,640,2988,0
883,3.22015,64,0,1,0,83.833,64,8189,1,0,386,1,5.27866,2944,641,2989,0
707,2.57822,68,0,4,0,87.936,68,8140,4,0,271,4,5.97542,2948,645,2993,0
709,2.58578,72,0,1,0,65.837,72,8191,1,0,319,1,5.86234,2949,646,2994,0
805,2.93592,77,0,5,0,77.582,77,8190,5,0,332,5,4.35206,2954,651,2999,0
785,2.86296,80,0,6,0,75.863,80,8191,6,0,243,6,4.13683,2960,657,3005,0
720,2.62576,83,0,4,0,79.856,83,8189,4,0,246,4,5.79667,2964,661,3009,0
531,1.93641,45,0,83,0,92.164,45,8189,67,0,215,0,6.50803,3031,661,3092,0
641,2.33763,51,0,1,0,63.054,51,8189,1,0,300,1,6.94579,3032,662,3093,0
746,2.7206,57,0,2,0,58.986,57,8189,2,0,323,2,5.80762,3034,664,3095,0
774,2.8227,63,0,1,0,60.28,63,8189,1,0,365,1,5.09261,3035,665,3096,0
641,2.33768,67,0,1,0,84.734,67,8189,1,0,293,1,5.54861,3036,666,3097,0
796,2.90293,73,0,2,0,81.612,73,8189,2,0,368,2,6.45696,3038,668,3099,0
820,2.99039,77,0,3,0,99.767,77,8189,3,0,337,3,4.9175,3041,671,3102,0
608,2.21723,9,0,83,0,87.433,9,8189,83,0,186,4,4.70592,3124,675,3185,0
506,1.84543,44,0,0,0,87.736,44,8189,0,0,240,0,4.87008,3124,675,3185,0
756,2.75711,51,0,0,0,46.597,51,8189,0,0,379,0,4.0055,3124,675,3185,0
776,2.83017,58,0,2,0,56.567,58,8189,2,0,336,2,4.68403,3126,677,3187,0
626,2.2831,62,0,2,0,72.974,62,8189,2,0,256,2,3.44736,3128,679,3189,0
498,1.81609,33,0,64,0,29.613,33,8189,64,0,207,1,4.31558,3192,680,3253,0
588,2.14451,41,0,0,0,79.827,41,8187,0,0,293,0,5.65805,3192,680,3253,0
763,2.78267,50,0,0,0,68.73,50,8189,0,0,382,0,5.76019,3192,680,3253,0
857,3.12541,57,0,1,0,64.246,57,8189,1,0,407,1,4.45056,3193,681,3254,0
776,2.83004,63,0,2,0,72.25,63,8189,2,0,334,2,5.57414,3195,683,3256,0
861,3.14018,69,0,2,0,73.32,69,8187,2,0,402,2,7.65715,3197,685,3258,0
628,2.29024,28,0,75,0,58.966,28,8189,75,0,236,3,6.69773,3272,688,3333,0
675,2.46187,44,0,0,0,54.254,44,8189,0,0,336,0,5.0087,3272,688,3333,0
680,2.48012,50,0,1,0,91.953,50,8189,1,0,322,1,5.76019,3273,689,3334,0
711,2.593,57,0,0,0,85.011,57,8189,0,0,359,0,6.6576,3273,689,3334,0
526,1.91831,14,0,62,0,67.901,14,8189,62,0,231,1,7.14643,3335,690,3396,0
629,2.29387,38,0,0,0,49.879,38,8189,0,0,307,0,5.4647,3335,690,3396,0
686,2.50171,46,0,0,0,44.231,46,8189,0,0,344,0,3.69542,3335,690,3396,0
735,2.68063,53,0,0,0,48.723,53,8189,0,0,370,0,6.2928,3335,690,3396,0
528,1.92565,28,0,58,0,37.107,28,8189,58,0,225,1,6.55181,3393,691,3454,0
614,2.23924,37,0,0,0,45.32,37,8189,0,0,312,0,6.31469,3393,691,3454,0
592,2.15904,44,0,0,0,54.736,44,8189,0,0,297,0,5.99731,3393,691,3454,0
696,2.53835,52,0,0,0,51.208,52,8190,0,0,348,0,5.26406,3393,691,3454,0
807,2.9431,58,0,1,0,74.271,58,8189,1,0,381,1,6.32928,3394,692,3455,0
799,2.91389,64,0,1,0,70.909,64,8189,1,0,373,1,6.07392,3395,693,3456,0
625,2.27933,35,0,68,0,65.467,35,8189,68,0,235,2,6.51898,3463,695,3524,0
639,2.33038,43,0,0,0,48.458,43,8189,0,0,320,0,6.34387,3463,695,3524,0
773,2.81906,50,0,2,0,57.182,50,8189,2,0,341,2,4.9248,3465,697,3526,0
579,2.11159,29,0,54,0,38.182,29,8189,54,0,255,1,5.79302,3519,698,3580,0
586,2.13697,37,0,0,0,48.297,37,8189,0,0,296,0,4.52717,3519,698,3580,0
600,2.18827,44,0,0,0,65.088,45,8189,0,0,304,0,4.41043,3519,698,3580,0
628,2.29024,51,0,1,0,62.026,51,8190,1,0,314,1,4.3849,3520,699,3581,0
800,2.91773,58,0,1,0,60.037,58,8189,1,0,352,1,4.78982,3521,700,3582,0
784,2.85942,63,0,3,0,61.046,63,8130,3,0,308,3,5.04154,3524,703,3585,0
647,2.3596,67,0,1,0,95.315,67,8189,1,0,294,1,5.91706,3525,704,3586,0
456,1.66299,34,0,70,0,64.298,34,8189,70,0,181,1,7.27411,3595,705,3656,0
593,2.16268,42,0,0,0,73.708,42,8189,0,0,300,0,6.43872,3595,705,3656,0
708,2.58215,49,0,1,0,89.393,49,8189,1,0,335,1,5.59603,3596,706,3657,0
660,2.40707,56,0,0,0,64.593,56,8189,0,0,331,0,6.63571,3596,706,3657,0
755,2.75361,60,0,1,0,80.335,62,8189,1,0,351,1,4.82266,3597,707,3658,0
854,3.1144,68,0,1,0,79.321,68,8187,1,0,398,1,5.39539,3598,708,3659,0
706,2.57468,71,0,4,0,87.707,71,8187,4,0,257,4,5.45011,3602,712,3663,0
630,2.29746,41,0,71,0,50.297,41,8189,71,0,264,0,5.47565,3673,712,3734,0
730,2.66221,49,0,0,0,76.105,49,8189,0,0,367,0,4.14778,3673,712,3734,0
797,2.90669,56,0,2,0,63.703,56,8190,2,0,373,2,4.68768,3675,714,3736,0
684,2.49448,61,0,1,0,75.011,61,8131,1,0,291,1,3.82675,3676,715,3737,0
635,2.31588,65,0,1,0,110.629,65,8189,1,0,290,1,4.72781,3677,716,3738,0
768,2.80107,70,0,2,0,84.724,70,8189,2,0,355,2,5.56685,3679,718,3740,0
712,2.59669,37,0,74,0,61.553,37,8189,74,0,306,1,5.59968,3753,719,3814,0
714,2.60386,46,0,0,0,58.6,46,8189,0,0,361,0,6.68314,3753,719,3814,0
766,2.79352,53,0,2,0,63.383,53,8189,2,0,337,2,5.69088,3755,721,3816,0
684,2.49469,58,0,1,0,55.827,58,8187,1,0,317,1,4.61837,3756,722,3817,0
536,1.95477,31,0,62,0,34.937,31,8189,62,0,202,2,4.53811,3818,724,3879,0
765,2.78988,42,0,0,0,37.875,42,8189,0,0,386,0,4.83725,3818,724,3879,0
776,2.83016,50,0,0,0,52.262,50,8189,0,0,391,0,4.7497,3818,724,3879,0
677,2.46905,56,0,2,0,61.297,56,8189,2,0,289,2,5.6617,3820,726,3881,0
721,2.62953,34,0,58,0,39.035,34,8189,58,0,351,0,5.81856,3878,726,3939,0
653,2.38146,43,0,0,0,47.132,43,8189,0,0,328,0,6.61382,3878,726,3939,0
808,2.94671,51,0,0,0,51.466,51,8189,0,0,405,0,5.55955,3878,726,3939,0
835,3.04514,58,0,2,0,74.301,58,8190,2,0,392,2,5.87693,3880,728,3941,0
785,2.8627,63,0,3,0,76.042,63,8189,3,0,309,3,4.56365,3883,731,3944,0
825,3.00886,69,0,2,0,72.95,69,8189,2,0,349,2,6.59558,3885,733,3946,0
779,2.84141,74,0,1,0,77.849,74,8187,1,0,357,1,6.40589,3886,734,3947,0
874,3.18761,78,0,3,0,87.099,78,8189,3,0,366,3,5.27501,3889,737,3950,0
741,2.70243,82,0,7,0,89.739,82,8189,7,0,256,7,8.02925,3896,744,3957,0
660,2.40697,22,0,87,0,53.724,22,8189,87,0,201,3,5.4793,3983,747,4044,0
706,2.57464,48,0,1,0,58.883,48,8191,1,0,324,1,4.3776,3984,748,4045,0
789,2.87684,54,0,1,0,61.83,55,8189,1,0,371,1,4.81171,3985,749,4046,0
761,2.77553,61,0,1,0,55,61,8189,1,0,357,1,4.60742,3986,750,4047,0
748,2.72795,67,0,1,0,72.839,67,8189,1,0,347,1,5.25312,3987,751,4048,0
652,2.37786,70,0,3,0,63.884,70,8189,3,0,232,3,5.48294,3990,754,4051,0
587,2.14085,39,0,72,0,46.96,39,8189,72,0,244,1,4.66214,4062,755,4123,0
810,2.95392,48,0,0,0,43.584,48,8189,0,0,410,0,3.67354,4062,755,4123,0
859,3.13266,56,0,2,0,65.086,56,8190,2,0,407,2,4.31923,4064,757,4125,0
713,2.59966,61,0,2,0,62.875,61,8189,2,0,280,2,4.46515,4066,759,4127,0
523,1.90745,6,0,68,0,51.481,6,8189,68,0,229,1,4.76429,4134,760,4195,0
331,1.20715,19,0,0,0,35.144,19,8189,0,0,165,0,3.90701,4134,760,4195,0
538,1.96201,30,0,0,0,46.464,30,8189,0,0,270,0,3.79027,4134,760,4195,0
658,2.39957,39,0,0,0,52.551,39,8190,0,0,334,0,5.47565,4134,760,4195,0
773,2.81899,48,0,1,0,50.941,48,8189,1,0,366,1,4.70227,4135,761,4196,0
705,2.57105,55,0,0,0,96.518,55,8189,0,0,355,0,4.87738,4135,761,4196,0
823,3.00145,61,0,1,0,69.181,61,8130,1,0,383,1,4.9248,4136,762,4197,0
803,2.92852,66,0,4,0,63.911,66,8189,4,0,323,4,4.45786,4140,766,4201,0
741,2.70239,70,0,3,0,85.815,70,8189,3,0,279,3,6.30374,4143,769,4204,0
787,2.87019,75,0,2,0,71.087,75,8191,2,0,328,2,4.98682,4145,771,4206,0
748,2.72773,79,0,3,0,86.739,79,8190,3,0,343,3,5.65805,4148,774,4209,0
614,2.23914,42,0,82,0,60.5,42,8189,82,0,213,2,5.74925,4230,776,4291,0
645,2.35238,50,0,0,0,54.502,50,8191,0,0,327,0,4.03469,4230,776,4291,0
675,2.46184,55,0,1,0,79.391,55,8191,1,0,317,1,4.30464,4231,777,4292,0
782,2.85194,62,0,1,0,72.512,62,8189,1,0,366,1,5.07072,4232,778,4293,0
715,2.60741,65,0,4,0,61.32,65,8191,4,0,240,4,5.06342,4236,782,4297,0
801,2.92117,70,0,2,0,77.381,70,8189,2,0,339,2,4.42502,4238,784,4299,0
759,2.76821,75,0,2,0,75.002,75,8117,2,0,314,2,5.88058,4240,786,4301,0
702,2.5602,78,0,4,0,95.696,78,8190,4,0,280,4,5.80762,4244,790,4305,0
864,3.15027,82,0,4,0,80.206,82,8189,4,0,316,4,5.26771,4248,794,4309,0
723,2.6367,85,0,5,0,81.006,85,8191,5,0,242,5,5.6544,4253,799,4314,0
832,3.0341,89,0,3,0,81.556,89,8189,3,0,335,3,7.04429,4256,802,4317,0
744,2.7133,92,0,3,0,86.958,92,8189,3,0,285,3,6.53357,4259,805,4320,0
785,2.86298,95,0,9,0,96.031,95,8191,9,0,255,9,5.3808,4268,814,4329,0
712,2.59683,48,0,101,0,34.513,48,8189,101,0,196,5,4.77888,4369,819,4430,0
774,2.82286,55,0,1,0,60.452,55,8136,1,0,363,1,5.77114,4370,820,4431,0
839,3.05991,61,0,3,0,72.774,61,8191,3,0,364,3,4.90656,4373,823,4434,0
549,2.00224,33,0,64,0,61.748,33,8189,64,0,231,1,4.31558,4437,824,4498,0
696,2.5383,42,0,0,0,45.137,42,8191,0,0,347,0,3.90701,4437,824,4498,0
750,2.73523,50,0,0,0,50.717,50,8191,0,0,376,0,4.97222,4437,824,4498,0
782,2.85098,58,0,0,0,75.289,58,8189,0,0,391,0,5.69818,4437,824,4498,0
816,2.97591,63,0,2,0,65.459,63,8191,2,0,352,2,5.41363,4439,826,4500,0
697,2.54193,68,0,1,0,59.563,68,8191,1,0,322,1,4.18426,4440,827,4501,0
763,2.78246,72,0,75,0,72.243,2,8189,75,0,279,3,4.18426,4515,830,4576,0
578,2.10755,40,0,0,0,47.638,42,8191,0,0,278,0,3.22483,4515,830,4576,0
725,2.64393,50,0,0,0,62.659,50,8191,0,0,361,0,5.31878,4515,830,4576,0
790,2.88102,56,0,2,0,49.159,56,8191,2,0,348,2,5.1145,4517,832,4578,0
694,2.53017,61,0,2,0,71.464,61,8191,2,0,295,2,5.05248,4519,834,4580,0
705,2.57121,10,0,68,0,77.077,10,8191,68,0,292,2,6.97498,4587,836,4648,0
568,2.07145,39,0,0,0,46.852,39,8191,0,0,276,0,4.3703,4587,836,4648,0
705,2.57111,48,0,0,0,77.38,48,8191,0,0,356,0,4.64026,4587,836,4648,0
778,2.83713,53,0,0,0,67.357,55,8191,0,0,391,0,3.65165,4587,836,4648,0
832,3.03427,60,0,4,0,65.033,60,8189,4,0,308,4,3.89242,4591,840,4652,0
770,2.80817,66,0,3,0,65.494,66,8191,3,0,327,3,4.02374,4594,843,4655,0
794,2.89553,70,0,4,0,74.057,70,8191,4,0,276,4,4.57824,4598,847,4659,0
612,2.23178,36,0,76,0,37.643,36,8191,76,0,186,4,4.26086,4674,851,4735,0
664,2.42154,44,0,0,0,50.276,44,8189,0,0,334,0,4.88832,4674,851,4735,0
813,2.96454,52,0,0,0,59.758,52,8191,0,0,408,0,4.50163,4674,851,4735,0
754,2.74979,58,0,3,0,59.718,58,8189,3,0,302,3,5.23853,4677,854,4738,0
738,2.69149,63,0,2,0,70.375,63,8189,2,0,313,2,5.09626,4679,856,4740,0
707,2.57855,67,0,3,0,69.562,67,8189,3,0,262,3,5.66534,4682,859,4743,0
635,2.31583,37,0,70,0,46.195,37,8189,70,0,238,2,4.89197,4752,861,4813,0
673,2.45441,3,0,46,0,72.101,3,8191,46,0,314,1,5.30419,4798,862,4859,0
459,1.67395,29,0,0,0,42.149,29,8191,0,0,224,0,5.43917,4798,862,4859,0
638,2.32676,39,0,0,0,36.561,39,8189,0,0,317,0,3.77203,4798,862,4859,0
654,2.3851,46,0,0,0,42.245,46,8189,0,0,330,0,3.96173,4798,862,4859,0
706,2.5749,52,0,1,0,61.107,53,8189,1,0,328,1,5.69818,4799,863,4860,0
774,2.82287,59,0,3,0,63.669,59,8191,3,0,334,3,4.69133,4802,866,4863,0
705,2.57107,64,0,1,0,96.785,64,8191,1,0,301,1,4.4615,4803,867,4864,0
728,2.65493,68,0,4,0,68.542,68,8189,4,0,304,4,4.94304,4807,871,4868,0
835,3.04514,73,0,2,0,72.904,73,8189,2,0,322,2,4.71322,4809,873,4870,0
729,2.65872,77,0,2,0,93.061,77,8185,2,0,332,2,4.25357,4811,875,4872,0
740,2.69873,81,0,3,0,82.786,81,8191,3,0,295,3,5.03424,4814,878,4875,0
525,1.91454,9,0,85,0,85.028,9,8189,85,0,179,2,5.85869,4899,880,4960,0
744,2.71297,47,0,1,0,46.576,47,8191,1,0,339,1,6.14323,4900,881,4961,0
743,2.7097,55,0,0,0,65.741,55,8189,0,0,371,0,4.31558,4900,881,4961,0
555,2.02406,33,0,55,0,54.87,33,8189,55,0,268,0,5.25312,4955,881,5016,0
676,2.46532,42,0,0,0,49.972,42,8191,0,0,342,0,5.88058,4955,881,5016,0
772,2.81559,49,0,0,0,59.732,51,8190,0,0,388,0,4.88467,4955,881,5016,0
615,2.24289,56,0,1,0,63.559,56,8191,1,0,308,1,6.77069,4956,882,5017,0
456,1.66309,31,0,58,0,77.883,31,8191,58,0,163,1,4.57459,5014,883,5075,0
675,2.46195,40,0,0,0,47.679,40,8191,0,0,340,0,4.00915,5014,883,5075,0
733,2.67327,48,0,0,0,62.12,48,8191,0,0,368,0,4.81171,5014,883,5075,0
740,2.69892,55,0,0,0,59.72,55,8189,0,0,373,0,5.59238,5014,883,5075,0
687,2.50547,60,0,2,0,72.589,60,8189,2,0,293,2,5.13638,5016,885,5077,0
678,2.47264,64,0,3,0,68.011,64,8189,3,0,252,3,5.50118,5019,888,5080,0
791,2.88478,69,0,2,0,65.753,69,8189,2,0,335,2,5.58874,5021,890,5082,0
869,3.16915,74,0,3,0,69.388,74,8191,3,0,365,3,5.26406,5024,893,5085,0
765,2.7899,78,0,3,0,68.564,78,8189,3,0,278,3,6.21254,5027,896,5088,0
649,2.36699,41,0,82,0,42.914,41,8189,82,0,231,2,5.85504,5109,898,5170,0
711,2.59051,49,0,0,0,75.257,49,8189,0,0,360,0,4.33018,5109,898,5170,0
733,2.67327,56,0,0,0,68.039,56,8191,0,0,368,0,5.30419,5109,898,5170,0
707,2.5784,33,0,60,0,36.042,33,8190,60,0,294,2,4.99776,5169,900,5230,0
648,2.36315,42,0,0,0,36.672,42,8189,0,0,327,0,4.72416,5169,900,5230,0
621,2.26482,48,0,0,0,46.06,48,8187,0,0,312,0,5.52672,5169,900,5230,0
657,2.39611,54,0,1,0,63.833,54,8191,1,0,307,1,5.24947,5170,901,5231,0
741,2.70248,60,0,2,0,63.891,60,8190,2,0,346,2,5.36986,5172,903,5233,0
617,2.2501,11,0,66,0,64.635,11,8189,66,0,220,2,6.08851,5238,905,5299,0
371,1.35305,19,0,34,0,65.58,19,8189,34,0,170,0,5.5632,5272,905,5333,0
468,1.70667,29,0,0,0,35.106,29,8189,0,0,236,0,5.88422,5272,905,5333,0
628,2.29038,38,0,0,0,34.764,38,8191,0,0,316,0,6.94214,5272,905,5333,0
662,2.41426,46,0,0,0,63.275,46,8189,0,0,333,0,5.9207,5272,905,5333,0
692,2.52366,53,0,0,0,59.819,53,8189,0,0,346,0,5.74925,5272,905,5333,0
856,3.1218,60,0,2,0,65.007,60,8189,2,0,381,2,6.59194,5274,907,5335,0
806,2.9395,65,0,3,0,77.329,65,8189,3,0,317,3,5.2823,5277,910,5338,0
748,2.72786,69,0,5,0,81.396,69,8190,5,0,283,5,4.92115,5282,915,5343,0
674,2.45799,36,0,74,0,50.68,36,8189,74,0,254,2,5.35526,5356,917,5417,0
830,3.0269,46,0,0,0,43.334,46,8191,0,0,415,0,5.89882,5356,917,5417,0
853,3.11091,54,0,0,0,62.966,54,8191,0,0,427,0,5.08896,5356,917,5417,0
834,3.04176,61,0,1,0,58.108,61,8189,1,0,392,1,3.97632,5357,918,5418,0
762,2.77915,66,0,4,0,70.472,66,8189,4,0,319,4,5.55226,5361,922,5422,0
717,2.61495,34,0,73,0,37.161,34,8189,73,0,246,4,3.97997,5434,926,5495,0
740,2.69871,43,0,0,0,44.692,43,8191,0,0,372,0,3.93619,5434,926,5495,0
695,2.53476,50,0,1,0,47.358,50,8189,1,0,327,1,5.2057,5435,927,5496,0
844,3.07819,57,0,1,0,47.83,57,8189,1,0,399,1,5.64346,5436,928,5497,0
737,2.68797,64,0,0,0,82.168,64,8191,0,0,371,0,5.5632,5436,928,5497,0
734,2.67705,69,0,1,0,63.764,69,8189,1,0,341,1,5.41728,5437,929,5498,0
665,2.4253,38,0,72,0,50.406,38,8189,72,0,253,2,5.1911,5509,931,5570,0
740,2.69878,46,0,0,0,51.823,46,8189,0,0,371,0,4.53446,5509,931,5570,0
704,2.56747,53,0,0,0,51.929,53,8189,0,0,354,0,5.0233,5509,931,5570,0
687,2.50544,59,0,2,0,67.793,59,8189,2,0,318,2,5.1984,5511,933,5572,0
729,2.65862,64,0,2,0,85.95,64,8189,2,0,310,2,5.76384,5513,935,5574,0
821,2.99414,69,0,3,0,60.157,69,8189,3,0,349,3,4.80077,5516,938,5577,0
432,1.57548,10,0,78,0,34.12,10,8189,78,0,147,1,5.00141,5594,939,5655,0
343,1.25093,21,0,0,0,25.753,21,8189,0,0,175,0,5.03059,5594,939,5655,0
559,2.03871,31,0,0,0,35.16,31,8191,0,0,279,0,5.14368,5594,939,5655,0
695,2.53462,41,0,0,0,46.263,41,8191,0,0,348,0,4.92115,5594,939,5655,0
761,2.77531,49,0,1,0,47.881,49,8189,1,0,360,1,4.89562,5595,940,5656,0
734,2.67696,55,0,2,0,65.401,55,8190,2,0,344,2,5.61427,5597,942,5658,0
822,2.99803,61,0,1,0,76.657,61,8189,1,0,360,1,5.5632,5598,943,5659,0
775,2.82651,66,0,3,0,62.994,66,8189,3,0,301,3,4.64755,5601,946,5662,0
744,2.71318,3,0,75,0,66.858,3,8121,75,0,238,5,4.43597,5676,951,5737,0
571,2.08227,41,0,0,0,99.491,41,8189,0,0,273,0,4.90656,5676,951,5737,0
740,2.69877,49,0,0,0,101.435,49,8189,0,0,370,0,4.86278,5676,951,5737,0
664,2.42153,54,0,2,0,59.466,54,8191,2,0,287,2,5.44282,5678,953,5739,0
758,2.76432,61,0,1,0,58.195,61,8189,1,0,356,1,5.43917,5679,954,5740,0
553,2.01675,17,0,66,0,56.288,17,8189,66,0,212,2,5.72371,5745,956,5806,0
660,2.4069,40,0,0,0,58.516,40,8189,0,0,324,0,5.70182,5745,956,5806,0
658,2.39979,48,0,0,0,57.885,48,8189,0,0,331,0,4.75334,5745,956,5806,0
651,2.37406,54,0,0,0,64.595,54,8189,0,0,328,0,5.7529,5745,956,5806,0
838,3.0561,61,0,1,0,47.969,61,8189,1,0,393,1,5.37715,5746,957,5807,0
772,2.81557,66,0,2,0,78.621,66,8190,2,0,359,2,3.85594,5748,959,5809,0
792,2.88849,9,0,74,0,79.208,9,8189,74,0,297,3,3.71731,5822,962,5883,0
608,2.21751,41,0,0,0,43.805,41,8189,0,0,294,0,4.58189,5822,962,5883,0
817,2.97975,50,0,1,0,47.268,50,8189,1,0,386,1,6.0192,5823,963,5884,0
875,3.19111,58,0,0,0,60.328,58,8189,0,0,440,0,6.79258,5823,963,5884,0
743,2.70968,63,0,2,0,63.278,63,8129,2,0,317,2,5.28595,5825,965,5886,0
775,2.82638,68,0,2,0,68.334,68,8189,2,0,327,2,4.7351,5827,967,5888,0
827,3.01592,72,0,3,0,75.96,72,8189,3,0,312,3,5.45011,5830,970,5891,0
834,3.04171,77,0,2,0,89.068,77,8191,2,0,350,2,5.24947,5832,972,5893,0
339,1.23637,39,0,78,0,105.888,39,8189,78,0,117,2,6.53357,5910,974,5971,0
591,2.15534,46,0,0,0,59.549,46,8189,0,0,298,0,7.32518,5910,974,5971,0
722,2.63309,53,0,0,0,54.049,53,8189,0,0,364,0,6.24902,5910,974,5971,0
739,2.69508,59,0,1,0,50.842,59,8189,1,0,343,1,5.60333,5911,975,5972,0
596,2.17355,32,0,63,0,53.518,32,8191,63,0,254,1,5.58144,5974,976,6035,0
652,2.37751,41,0,0,0,78.522,41,8191,0,0,327,0,5.20205,5974,976,6035,0
785,2.86283,49,0,0,0,56.351,49,8189,0,0,393,0,4.42502,5974,976,6035,0
701,2.55659,56,0,0,0,69.182,56,8189,0,0,352,0,3.60422,5974,976,6035,0
724,2.64047,61,0,2,0,56.894,61,8191,2,0,310,2,6.7561,5976,978,6037,0
784,2.85925,66,0,3,0,63.972,66,8191,3,0,306,3,5.5705,5979,981,6040,0
776,2.83011,71,0,1,0,95.955,71,8191,1,0,360,1,5.78938,5980,982,6041,0
834,3.04175,76,0,4,0,73.181,76,8188,4,0,316,4,6.58464,5984,986,6045,0
752,2.74268,79,0,3,0,77.663,79,8191,3,0,266,3,4.5673,5987,989,6048,0
593,2.16253,40,0,82,0,34.116,40,8189,82,0,164,2,4.04928,6069,991,6130,0
768,2.80083,48,0,0,0,48.006,48,8189,0,0,385,0,5.74195,6069,991,6130,0
463,1.68854,53,0,0,0,54.76,53,8191,0,0,236,0,5.89517,6069,991,6130,0
844,3.07812,60,0,1,0,62.414,60,8189,1,0,395,1,5.39904,6070,992,6131,0
714,2.60402,65,0,2,0,63.238,65,8189,2,0,302,2,5.5632,6072,994,6133,0
789,2.87778,69,0,4,0,67.438,69,8189,4,0,297,4,6.40589,6076,998,6137,0
781,2.84832,74,0,2,0,81.289,74,8189,2,0,323,2,4.88102,6078,1000,6139,0
815,2.97219,78,0,3,0,89.429,78,8187,3,0,302,3,3.5568,6081,1003,6142,0
841,3.06704,81,0,5,0,69.149,81,8189,5,0,312,5,4.04563,6086,1008,6147,0
727,2.65113,84,0,5,0,107.394,84,8190,5,0,246,5,4.25722,6091,1013,6152,0
843,3.0745,88,0,4,0,83.312,88,8190,4,0,298,4,3.42182,6095,1017,6156,0
694,2.53115,48,0,89,0,85.01,48,8191,89,0,271,1,5.32973,6184,1018,6245,0
644,2.34863,54,0,2,0,73.521,54,8189,2,0,276,2,5.46106,6186,1020,6247,0
685,2.49813,59,0,2,0,78.314,59,8189,2,0,295,2,6.74515,6188,1022,6249,0
780,2.8448,64,0,3,0,75.571,64,8189,3,0,305,3,5.38445,6191,1025,6252,0
796,2.90293,69,0,3,0,77.546,69,8189,3,0,334,3,4.06022,6194,1028,6255,0
472,1.72137,30,0,73,0,57.041,30,8185,73,0,157,2,3.88877,6267,1030,6328,0
562,2.04945,42,0,0,0,76.603,42,8189,0,0,280,0,5.14003,6267,1030,6328,0
517,1.88546,47,0,0,0,65.348,47,8191,0,0,263,0,5.86234,6267,1030,6328,0
714,2.60389,54,0,1,0,53.098,54,8189,1,0,359,1,4.88102,6268,1031,6329,0
816,2.97543,61,0,1,0,62.634,61,8189,1,0,360,1,4.90656,6269,1032,6330,0
832,3.03417,66,0,3,0,68.652,66,8190,3,0,364,3,5.16557,6272,1035,6333,0
688,2.50925,70,0,3,0,85.295,70,8189,3,0,248,3,5.22029,6275,1038,6336,0
657,2.39612,4,0,75,0,77.14,4,8191,75,0,229,2,5.67264,6350,1040,6411,0
604,2.20249,42,0,0,0,99.907,42,8190,0,0,287,0,5.50483,6350,1040,6411,0
572,2.08606,48,0,0,0,79.416,48,8189,0,0,288,0,5.91706,6350,1040,6411,0
722,2.63305,55,0,1,0,52.815,55,8189,1,0,336,1,6.76339,6351,1041,6412,0
750,2.7353,60,0,3,0,56.985,60,8189,3,0,296,3,6.63206,6354,1044,6415,0
763,2.78273,65,0,4,0,71.652,65,8189,4,0,294,4,5.27866,6358,1048,6419,0
705,2.57108,5,0,72,0,62.657,5,8190,72,0,226,4,4.04563,6430,1052,6491,0
747,2.72421,42,0,0,0,33.011,42,8187,0,0,362,0,6.19795,6430,1052,6491,0
757,2.76073,50,0,1,0,54.471,50,8189,1,0,356,1,3.72096,6431,1053,6492,0
846,3.08523,57,0,1,0,64.785,57,8189,1,0,397,1,5.37715,6432,1054,6493,0
638,2.3267,34,0,59,0,35.321,34,8189,59,0,276,1,5.42822,6491,1055,6552,0
807,2.94313,44,0,0,0,51.037,44,8189,0,0,403,0,3.67354,6491,1055,6552,0
814,2.96877,52,0,1,0,57.009,52,8189,1,0,384,1,4.22074,6492,1056,6553,0
532,1.94031,30,0,56,0,45.46,30,8189,56,0,206,2,5.77114,6548,1058,6609,0
738,2.69162,40,0,0,0,39.456,40,8189,0,0,371,0,5.81856,6548,1058,6609,0
821,2.9942,49,0,0,0,52.481,49,8190,0,0,413,0,4.19155,6548,1058,6609,0
786,2.86651,56,0,2,0,77.023,56,8187,2,0,370,2,5.90246,6550,1060,6611,0
826,3.01237,62,0,2,0,63.137,62,8189,2,0,361,2,4.6585,6552,1062,6613,0
808,2.94685,67,0,2,0,69.353,67,8189,2,0,324,2,4.14413,6554,1064,6615,0
827,3.01603,71,0,5,0,67.774,71,8189,5,0,290,5,5.2823,6559,1069,6620,0
574,2.09336,37,0,76,0,40.15,37,8189,76,0,203,3,4.81901,6635,1072,6696,0
773,2.81918,46,0,0,0,41.695,46,8189,0,0,388,0,5.97907,6635,1072,6696,0
784,2.85885,53,0,0,0,71.673,54,8189,0,0,394,0,4.23168,6635,1072,6696,0
553,2.01674,28,0,60,0,55.235,28,8189,60,0,187,3,4.95398,6695,1075,6756,0
638,2.32674,38,0,0,0,42.831,38,8189,0,0,322,0,5.0999,6695,1075,6756,0
773,2.81906,47,0,0,0,51.098,47,8189,0,0,386,0,3.97267,6695,1075,6756,0
905,3.30057,55,0,1,0,53.892,55,8189,1,0,427,1,5.55226,6696,1076,6757,0
600,2.1883,29,0,60,0,37.165,29,8189,60,0,209,3,3.93984,6756,1079,6817,0
699,2.54937,39,0,0,0,40.109,39,8189,0,0,352,0,4.93939,6756,1079,6817,0
766,2.79362,48,0,0,0,47.638,48,8191,0,0,383,0,5.89882,6756,1079,6817,0
829,3.02293,56,0,0,0,60.199,56,8189,0,0,418,0,4.71686,6756,1079,6817,0
746,2.72081,62,0,0,0,75.31,62,8190,0,0,379,0,6.64666,6756,1079,6817,0
720,2.62588,67,0,2,0,68.519,67,8189,2,0,302,2,4.95763,6758,1081,6819,0
685,2.49815,71,0,3,0,75.18,71,8189,3,0,313,3,5.3735,6761,1084,6822,0
860,3.13644,75,0,5,0,69.554,75,8189,5,0,262,5,5.86963,6766,1089,6827,0
765,2.79003,79,0,4,0,90.258,79,8187,4,0,310,4,5.45741,6770,1093,6831,0
605,2.20643,44,0,80,0,65.07,44,8191,80,0,247,1,6.5737,6850,1094,6911,0
823,3.00112,52,0,1,0,58.468,52,8189,1,0,385,1,5.17286,6851,1095,6912,0
714,2.60306,58,0,1,0,70.49,58,8191,1,0,359,1,3.58963,6852,1096,6913,0
872,3.18011,64,0,2,0,79.508,64,8189,2,0,351,2,3.74285,6854,1098,6915,0
864,3.15103,70,0,1,0,85.395,70,8189,1,0,403,1,5.58874,6855,1099,6916,0
346,1.26183,6,0,75,0,70.518,6,8187,75,0,136,1,6.29645,6930,1100,6991,0
229,0.835141,16,0,0,0,34.552,16,8189,0,0,117,0,5.76019,6930,1100,6991,0
441,1.60834,26,0,0,0,30.765,26,8191,0,0,224,0,5.01965,6930,1100,6991,0
639,2.33038,37,0,0,0,38.674,37,8191,0,0,321,0,5.60333,6930,1100,6991,0
592,2.15807,42,0,0,0,49.484,44,8191,0,0,298,0,7.08806,6930,1100,6991,0
751,2.73883,51,0,1,0,76.837,51,8191,1,0,352,1,6.71232,6931,1101,6992,0
675,2.4618,57,0,1,0,63.844,57,8191,1,0,315,1,5.5705,6932,1102,6993,0
745,2.71711,63,0,1,0,97.507,63,8191,1,0,346,1,5.17286,6933,1103,6994,0
780,2.84465,68,0,2,0,71.629,68,8189,2,0,364,2,5.15462,6935,1105,6996,0
769,2.80357,73,0,0,0,93.928,73,8189,0,0,355,0,6.36941,6935,1105,6996,0
757,2.75868,77,0,6,0,79.805,77,8189,6,0,270,6,4.75334,6941,1111,7002,0
642,2.3406,43,0,77,0,56.448,43,8189,77,0,265,0,6.44602,7018,1111,7079,0
760,2.77178,51,0,0,0,58.073,51,8189,0,0,382,0,6.66125,7018,1111,7079,0
703,2.56371,56,0,4,0,59.612,56,8189,4,0,275,4,4.5527,7022,1115,7083,0
732,2.66964,35,0,58,0,41.491,35,8189,58,0,353,0,4.35206,7080,1115,7141,0
775,2.82654,45,0,0,0,59.633,45,8189,0,0,387,0,5.12909,7080,1115,7141,0
773,2.81902,52,0,1,0,66.608,52,8191,1,0,369,1,5.77114,7081,1116,7142,0
781,2.84728,59,0,1,0,63.542,59,8189,1,0,366,1,7.22304,7082,1117,7143,0
798,2.91024,64,0,2,0,66.403,64,8191,2,0,345,2,6.64301,7084,1119,7145,0
802,2.92485,68,0,6,0,68.109,69,8191,6,0,306,6,6.24538,7090,1125,7151,0
784,2.85945,73,0,5,0,69.35,73,8191,5,0,259,5,5.12179,7095,1130,7156,0
572,2.08602,24,0,77,0,99.116,24,8191,77,0,243,1,5.15098,7172,1131,7233,0
790,2.88101,46,0,1,0,48.706,46,8189,1,0,370,1,5.08166,7173,1132,7234,0
655,2.38869,53,0,0,0,60.696,53,8189,0,0,329,0,7.00051,7173,1132,7234,0
741,2.70229,59,0,0,0,65.22,59,8189,0,0,374,0,4.96128,7173,1132,7234,0
703,2.56389,64,0,1,0,71.924,64,8189,1,0,327,1,5.46835,7174,1133,7235,0
854,3.11445,70,0,2,0,75.234,70,8189,2,0,365,2,5.65075,7176,1135,7237,0
575,2.09685,37,0,73,0,64.079,37,8191,73,0,237,1,6.85824,7249,1136,7310,0
694,2.53096,46,0,0,0,55.298,46,8189,0,0,350,0,5.85139,7249,1136,7310,0
752,2.74253,53,0,0,0,68.954,53,8189,0,0,377,0,5.19475,7249,1136,7310,0
800,2.91754,59,0,2,0,68.999,59,8191,2,0,349,2,5.78208,7251,1138,7312,0
813,2.96496,65,0,3,0,57.017,65,8189,3,0,352,3,4.57824,7254,1141,7315,0
717,2.61476,70,0,1,0,87.794,70,8189,1,0,327,1,4.82995,7255,1142,7316,0
791,2.88482,74,0,3,0,89.318,74,8189,3,0,332,3,5.18016,7258,1145,7319,0
802,2.92507,78,0,7,0,76.369,78,8189,7,0,257,7,4.35571,7265,1152,7326,0
664,2.42168,41,0,83,0,47.026,41,8189,14,0,236,4,6.79987,7279,1156,7409,0
809,2.95037,49,0,0,0,60.254,49,8189,0,0,405,0,6.15053,7279,1156,7409,0
693,2.52736,54,0,2,0,59.118,55,8189,2,0,304,2,4.08576,7281,1158,7411,0
776,2.83008,31,0,60,0,29.514,31,8189,60,0,343,1,4.26086,7341,1159,7471,0
728,2.65503,41,0,0,0,40.773,41,8189,0,0,365,0,4.79347,7341,1159,7471,0
793,2.89192,49,0,1,0,46.013,49,8191,1,0,377,1,4.99776,7342,1160,7472,0
840,3.06333,57,0,1,0,73.22,57,8183,1,0,396,1,5.77478,7343,1161,7473,0
745,2.71702,62,0,3,0,63.747,62,8172,3,0,317,3,6.17971,7346,1164,7476,0
784,2.85933,66,0,4,0,73.632,66,8189,4,0,299,4,4.87008,7350,1168,7480,0
727,2.65134,71,0,2,0,77.206,71,8189,2,0,330,2,4.17696,7352,1170,7482,0
712,2.59665,40,0,73,0,51.707,40,8189,73,0,273,1,5.13274,7425,1171,7555,0
802,2.92466,49,0,1,0,45.484,49,8189,1,0,382,1,4.67309,7426,1172,7556,0
773,2.81899,55,0,3,0,43.499,55,8189,3,0,315,3,4.09306,7429,1175,7559,0
759,2.76819,60,0,2,0,73.191,60,8189,2,0,331,2,4.12224,7431,1177,7561,0
872,3.18015,67,0,1,0,62.308,67,8189,1,0,408,1,4.42867,7432,1178,7562,0
706,2.57488,71,0,3,0,111.638,71,8189,3,0,289,3,7.73741,7435,1181,7565,0
747,2.72443,75,0,3,0,78.211,75,8189,3,0,303,3,6.86189,7438,1184,7568,0
778,2.83746,79,0,4,0,95.597,79,8191,4,0,319,4,5.22394,7442,1188,7572,0
762,2.77907,82,0,2,0,97.361,82,8189,2,0,268,2,5.13274,7444,1190,7574,0
801,2.92124,86,0,3,0,90.383,86,8191,3,0,322,3,6.05568,7447,1193,7577,0
719,2.62199,48,0,86,0,48.543,48,8189,86,0,299,0,3.58963,7533,1193,7663,0
789,2.87733,55,0,1,0,66.021,55,8189,1,0,373,1,4.05658,7534,1194,7664,0
817,2.97958,62,0,2,0,65.663,62,8189,2,0,381,2,5.2969,7536,1196,7666,0
596,2.17374,37,0,62,0,54.643,37,8181,62,0,257,0,6.45696,7598,1196,7728,0
750,2.73525,46,0,0,0,56.749,46,8189,0,0,376,0,5.59238,7598,1196,7728,0
829,3.02334,54,0,1,0,50.104,54,8191,1,0,395,1,6.54086,7599,1197,7729,0
791,2.88465,61,0,0,0,99.656,61,8191,0,0,399,0,6.61747,7599,1197,7729,0
557,2.03139,32,0,65,0,83.535,32,8189,65,0,208,2,4.70592,7664,1199,7794,0
615,2.24297,41,0,0,0,54.401,41,8189,0,0,312,0,4.97587,7664,1199,7794,0
700,2.55289,48,0,1,0,44.432,48,8189,1,0,330,1,4.39219,7665,1200,7795,0
772,2.81549,55,0,0,0,61.434,55,8190,0,0,390,0,4.67309,7665,1200,7795,0
822,2.99776,61,0,2,0,74.655,61,8191,2,0,357,2,4.56365,7667,1202,7797,0
853,3.11103,67,0,3,0,76.08,67,8189,3,0,344,3,5.33338,7670,1205,7800,0
732,2.66944,71,0,3,0,78.107,71,8190,3,0,307,3,5.76749,7673,1208,7803,0
791,2.88464,75,0,4,0,67.31,75,8116,4,0,292,4,5.2896,7677,1212,7807,0
738,2.69119,79,0,3,0,97.765,79,8189,3,0,293,3,6.85824,7680,1215,7810,0
576,2.10067,16,0,84,0,65.76,16,8189,84,0,169,3,4.29005,7764,1218,7894,0
739,2.69516,47,0,0,0,57.489,47,8189,0,0,359,0,4.37395,7764,1218,7894,0
756,2.75677,55,0,0,0,89.519,55,8189,0,0,379,0,5.08166,7764,1218,7894,0
616,2.24664,29,0,59,0,35.998,29,8191,59,0,270,1,4.66944,7823,1219,7953,0
582,2.12252,38,0,0,0,43.819,38,8189,0,0,289,0,4.77158,7823,1219,7953,0
833,3.03811,47,0,0,0,53.722,47,8189,0,0,415,0,6.19795,7823,1219,7953,0
689,2.51304,54,0,0,0,88.894,54,8189,0,0,347,0,5.07437,7823,1219,7953,0
374,1.36406,30,0,56,0,81.061,30,8189,56,0,148,1,4.40678,7879,1220,8009,0
764,2.7862,40,0,0,0,42.39,40,8189,0,0,383,0,5.45741,7879,1220,8009,0
748,2.72766,49,0,0,0,54.231,49,8189,0,0,375,0,6.26726,7879,1220,8009,0
741,2.70232,56,0,0,0,82.663,56,8191,0,0,371,0,4.00915,7879,1220,8009,0
820,2.9905,62,0,1,0,64.43,62,8190,1,0,388,1,5.57779,7880,1221,8010,0
842,3.07068,68,0,2,0,73.508,68,8189,2,0,360,2,5.08166,7882,1223,8012,0
176,0.641848,9,0,76,0,29.179,9,8189,76,0,52,1,4.76064,7958,1224,8088,0
313,1.14151,20,0,0,0,36.117,20,8191,0,0,156,0,3.65165,7958,1224,8088,0
564,2.05684,31,0,0,0,38.177,31,8189,0,0,286,0,4.31923,7958,1224,8088,0
666,2.42879,40,0,0,0,40.967,40,8189,0,0,337,0,5.24947,7958,1224,8088,0
541,1.97297,46,0,0,0,94.38,46,8189,0,0,272,0,5.52307,7958,1224,8088,0
490,1.78705,27,0,50,0,35.011,27,8189,50,0,215,1,5.41728,8008,1225,8138,0
534,1.94757,35,0,0,0,72.515,35,8189,0,0,268,0,6.03744,8008,1225,8138,0
674,2.45815,44,0,0,0,48.874,44,8191,0,0,341,0,5.94989,8008,1225,8138,0
746,2.72064,52,0,0,0,68.633,52,8189,0,0,376,0,5.86963,8008,1225,8138,0
734,2.67702,58,0,0,0,92.097,58,8189,0,0,371,0,5.36621,8008,1225,8138,0
773,2.81921,64,0,2,0,61.354,64,8191,2,0,333,2,4.44691,8010,1227,8140,0
766,2.79353,68,0,5,0,65.313,68,8191,5,0,264,5,4.58189,8015,1232,8145,0
738,2.69169,72,0,3,0,76.151,72,8189,3,0,273,3,4.97587,8018,1235,8148,0
757,2.76075,75,0,4,0,70.939,75,8117,4,0,238,4,3.15187,8022,1239,8152,0


