SendPacket,SendRate(Mb/s),FlightSize,ReceiveRate(Mb/s),Send Loss,Recv Loss,RTT(ms),CWnd,FlowWindow,Retrans,PktSndPeriod(us),RecvACK,RecvNAK,EstimatedBandwidth(Mb/s),Retrans_Total,NAK_TotalRecv,Total Send Loss,Total Recv Loss
552,2.88664,104,0,8,0,136.475,151,8172,7,0,149,8,5.51245,7,8,8,0
433,2.44448,4,0,190,0,110.303,4,8118,131,0,17,24,5.39384,138,32,198,0
638,3.60248,84,0,7,0,112.343,84,8189,7,0,187,7,6.17891,145,39,205,0
532,3.00383,85,0,11,0,93.074,85,8190,11,0,143,11,7.12778,156,50,216,0
396,2.23601,43,0,87,0,77.341,43,8189,60,0,98,2,6.58557,216,52,303,0
469,2.64812,47,0,5,0,64.455,47,8191,5,0,196,5,6.3653,221,57,308,0
594,3.35405,52,0,4,0,86.683,52,8189,4,0,229,4,7.32546,225,61,312,0
564,3.18477,55,0,7,0,86.281,55,8189,7,0,183,7,7.43842,232,68,319,0
580,3.27486,58,0,4,0,73.591,59,8189,4,0,212,4,6.96963,236,72,323,0
468,2.64239,61,0,7,0,90.501,61,8189,7,0,122,7,6.85667,243,79,330,0
538,3.03787,33,0,63,0,52.184,33,8187,61,0,201,1,8.12747,304,80,393,0
524,2.95837,39,0,5,0,59.868,39,8191,5,0,212,5,6.9075,309,85,398,0
555,3.13387,44,0,3,0,72.931,44,8191,3,0,221,3,6.3653,312,88,401,0
565,3.19023,48,0,4,0,55.263,48,8189,4,0,178,4,6.19021,316,92,405,0
578,3.26371,52,0,4,0,63.482,52,8189,4,0,200,4,6.22974,320,96,409,0
502,2.83419,55,0,7,0,83.578,55,8190,7,0,176,7,6.31446,327,103,416,0
316,1.78427,11,0,61,0,31.09,11,8189,61,0,105,1,5.64235,388,104,477,0
479,2.70463,25,0,0,0,35.611,25,8191,0,0,242,0,4.67654,388,104,477,0
570,3.21848,34,0,1,0,39.826,34,8191,1,0,274,1,3.47917,389,105,478,0
443,2.50149,38,0,3,0,56.201,38,8191,3,0,171,3,4.0835,392,108,481,0
496,2.80076,43,0,3,0,69.687,43,8191,3,0,209,3,5.32606,395,111,484,0
570,3.21877,48,0,4,0,68.062,48,8191,4,0,200,4,4.98154,399,115,488,0
535,3.02093,52,0,5,0,76.076,52,8191,5,0,197,5,6.94139,404,120,493,0
608,3.43321,56,0,4,0,77.778,56,8191,4,0,207,4,6.11678,408,124,497,0
573,3.23547,59,0,5,0,80.227,59,8189,5,0,205,5,5.17357,413,129,502,0
545,3.07728,62,0,4,0,86.193,62,8191,4,0,191,4,5.54634,417,133,506,0
548,3.09363,63,0,7,0,92.29,65,8191,7,0,155,7,6.3427,424,140,513,0
522,2.94738,67,0,6,0,89.094,67,8191,6,0,166,6,5.7892,430,146,519,0
540,3.04914,58,0,7,0,82.57,69,8191,7,0,95,7,4.18517,437,153,526,0
534,3.01516,69,0,6,0,101.799,71,8191,6,0,142,6,4.49016,443,159,532,0
566,3.19477,62,0,6,0,101.463,73,8189,6,0,156,6,6.42742,449,165,538,0
561,3.1675,74,0,5,0,119.496,75,8189,5,0,170,5,5.47291,454,170,543,0
539,3.04349,77,0,7,0,99.424,77,8191,7,0,161,7,5.20181,461,177,550,0
582,3.28631,77,0,4,0,108.032,79,8191,4,0,156,4,6.12243,465,181,554,0
456,2.57483,80,0,17,0,114.482,80,8189,17,0,91,17,7.29722,482,198,571,0
507,2.86271,43,0,81,0,57.938,43,8189,60,0,188,1,6.00947,542,199,652,0
485,2.73842,28,0,44,0,45.261,28,8189,44,0,212,1,4.48451,586,200,696,0
559,3.15629,37,0,0,0,62.487,37,8189,0,0,280,0,3.5413,586,200,696,0
571,3.22399,43,0,2,0,79.029,43,8150,2,0,246,2,4.55794,588,202,698,0
535,3.02089,44,0,4,0,68.143,47,8189,4,0,205,4,5.48986,592,206,702,0
584,3.2972,52,0,6,0,69.726,52,8189,6,0,221,6,5.72142,598,212,708,0
457,2.58043,3,0,58,0,83.655,3,8137,58,0,131,4,5.21875,656,216,766,0
511,2.88542,34,0,0,0,69.965,34,8189,0,0,247,0,4.46192,656,216,766,0
545,3.07723,40,0,3,0,60.851,40,8189,3,0,223,3,4.50146,659,219,769,0
490,2.76674,44,0,3,0,67.912,44,8189,3,0,192,3,4.72738,662,222,772,0
561,3.16783,49,0,6,0,77.95,49,8189,6,0,214,6,5.67059,668,228,778,0
451,2.5465,27,0,53,0,48.325,27,8191,53,0,167,3,7.24638,721,231,831,0
575,3.24687,36,0,0,0,58.428,36,8189,0,0,286,0,6.54038,721,231,831,0
434,2.45068,23,0,40,0,37.655,23,8189,40,0,174,2,6.33706,761,233,871,0
553,3.12243,32,0,0,0,45.171,32,8189,0,0,276,0,5.71578,761,233,871,0
525,2.96443,39,0,3,0,66.277,39,8190,3,0,229,3,4.62571,764,236,874,0
510,2.87958,43,0,3,0,71.004,43,8189,3,0,182,3,5.02107,767,239,877,0
528,2.9813,48,0,3,0,69.416,48,8189,3,0,202,3,5.42208,770,242,880,0
565,3.19017,52,0,3,0,78.8,52,8139,3,0,214,3,4.26424,773,245,883,0
442,2.49561,55,0,4,0,73.2,55,8191,4,0,150,4,3.70509,777,249,887,0
504,2.84568,57,0,5,0,84.716,57,8191,5,0,150,5,3.71074,782,254,892,0
506,2.85705,60,0,6,0,95.213,60,8191,6,0,153,6,3.86323,788,260,898,0
511,2.88529,62,0,5,0,92.598,62,8158,5,0,146,5,3.88582,793,265,903,0
564,3.18452,59,0,7,0,86.127,65,8191,7,0,163,7,5.68754,800,272,910,0
517,2.9195,37,0,66,0,70.754,37,8189,60,0,218,1,6.44437,860,273,976,0
564,3.18448,43,0,2,0,63.394,43,8189,2,0,245,2,5.32042,862,275,978,0
466,2.63132,47,0,4,0,72.946,47,8190,4,0,192,4,5.54634,866,279,982,0
582,3.28611,50,0,3,0,79.361,51,8189,3,0,204,3,5.55763,869,282,985,0
489,2.76049,52,0,6,0,84.186,54,8190,6,0,171,6,6.37659,875,288,991,0
412,2.32626,28,0,60,0,43.731,28,8189,60,0,115,4,6.53474,935,292,1051,0
564,3.18448,36,0,1,0,49.387,36,8190,1,0,268,1,5.76096,936,293,1052,0
614,3.46666,43,0,1,0,71.391,43,8189,1,0,291,1,6.96398,937,294,1053,0
489,2.76104,3,0,51,0,62.971,3,8186,51,0,160,4,6.0603,988,298,1104,0
223,1.259,15,0,3,0,30.199,15,8189,3,0,111,0,6.02077,991,298,1107,0
497,2.80575,26,0,0,0,41.858,26,8191,0,0,247,0,5.35995,991,298,1107,0
563,3.17889,35,0,0,0,54.026,35,8189,0,0,282,0,5.78355,991,298,1107,0
560,3.16211,42,0,1,0,73.748,42,8189,1,0,263,1,6.57427,992,299,1108,0
397,2.24149,46,0,4,0,75.898,46,8189,4,0,157,4,5.38819,996,303,1112,0
606,3.42182,51,0,2,0,71.989,51,8191,2,0,262,2,5.10014,998,305,1114,0
452,2.55225,27,0,56,0,44.62,27,8189,56,0,142,3,4.55229,1054,308,1170,0
508,2.86832,35,0,0,0,49.147,35,8190,0,0,257,0,4.64266,1054,308,1170,0
522,2.94753,41,0,3,0,62.143,41,8190,3,0,228,3,4.60312,1057,311,1173,0
436,2.46203,22,0,45,0,40.608,22,8189,45,0,154,2,4.55794,1102,313,1218,0
552,3.1167,32,0,0,0,45.893,32,8189,0,0,275,0,7.26898,1102,313,1218,0
603,3.40469,40,0,1,0,60.35,40,8189,1,0,285,1,6.17891,1103,314,1219,0
577,3.25792,45,0,3,0,64.126,45,8189,3,0,233,3,5.33171,1106,317,1222,0
555,3.1338,50,0,3,0,76.291,50,8189,3,0,213,3,5.30347,1109,320,1225,0
544,3.07167,53,0,6,0,77.774,53,8191,6,0,177,6,4.81774,1115,326,1231,0
458,2.586,27,0,57,0,52.024,27,8191,57,0,166,2,4.6596,1172,328,1288,0
567,3.20131,36,0,0,0,49.952,36,8190,0,0,287,0,4.99283,1172,328,1288,0
518,2.92471,42,0,3,0,71.346,42,8160,3,0,227,3,5.96429,1175,331,1291,0
353,1.99321,23,0,44,0,42.996,23,8189,44,0,143,1,6.11114,1219,332,1335,0
543,3.06625,33,0,0,0,44.585,33,8189,0,0,273,0,3.8124,1219,332,1335,0
565,3.19032,41,0,0,0,64.202,41,8189,0,0,286,0,3.2589,1219,332,1335,0
564,3.18487,46,0,3,0,67.134,46,8189,3,0,241,3,3.77851,1222,335,1338,0
522,2.94721,50,0,3,0,70.111,50,8189,3,0,197,3,3.90842,1225,338,1341,0
510,2.87963,54,0,4,0,86.118,54,8191,4,0,181,4,4.59182,1229,342,1345,0
536,3.02647,57,0,3,0,106.505,57,8191,3,0,192,3,5.67059,1232,345,1348,0
519,2.93048,60,0,5,0,91.896,60,8191,5,0,151,5,5.76661,1237,350,1353,0
502,2.83474,62,0,5,0,92.031,62,8191,5,0,168,5,5.17922,1242,355,1358,0
524,2.95882,64,0,6,0,90.179,65,8189,6,0,145,6,5.61411,1248,361,1364,0
467,2.63673,33,0,69,0,50.135,33,8189,69,0,127,4,5.2131,1317,365,1433,0
550,3.10551,40,0,2,0,54.046,40,8189,2,0,256,2,5.00978,1319,367,1435,0
549,3.09986,45,0,1,0,61.768,45,8189,1,0,237,1,6.17326,1320,368,1436,0
441,2.49027,26,0,49,0,35.508,26,8189,49,0,168,2,5.71013,1369,370,1485,0
486,2.74413,34,0,1,0,60.7,34,8190,1,0,245,1,3.80675,1370,371,1486,0
584,3.29736,41,0,1,0,67.654,41,8189,1,0,258,1,3.14594,1371,372,1487,0
525,2.96435,45,0,3,0,66.653,45,8189,3,0,207,3,3.58648,1374,375,1490,0
467,2.637,24,0,51,0,37.952,24,8189,51,0,160,3,5.648,1425,378,1541,0
571,3.22428,33,0,0,0,45.526,33,8189,0,0,284,0,5.0719,1425,378,1541,0
545,3.07733,40,0,1,0,67.888,40,8189,1,0,256,1,6.40483,1426,379,1542,0
496,2.80059,45,0,4,0,79.693,45,8189,4,0,187,4,6.57427,1430,383,1546,0
338,1.90864,21,0,48,0,47.61,25,8189,48,0,117,2,7.36499,1478,385,1594,0
515,2.9079,33,0,0,0,55.109,33,8190,0,0,260,0,7.12778,1478,385,1594,0
523,2.95301,40,0,1,0,65.962,40,8189,1,0,248,1,7.00917,1479,386,1595,0
438,2.47209,25,0,41,0,38.404,26,8191,41,0,191,1,6.86797,1520,387,1636,0
583,3.29134,36,0,0,0,68.639,36,8189,0,0,291,0,6.41613,1520,387,1636,0
508,2.8684,41,0,2,0,72.834,41,8189,2,0,220,2,5.41078,1522,389,1638,0
430,2.4279,27,0,42,0,38.422,27,8191,42,0,188,1,4.13434,1564,390,1680,0
532,3.00382,35,0,2,0,54.335,35,8189,2,0,256,2,4.9533,1566,392,1682,0
400,2.25846,24,0,35,0,40.806,24,8189,35,0,178,0,5.0945,1601,392,1717,0
592,3.34271,34,0,0,0,46.269,34,8189,0,0,297,0,6.38789,1601,392,1717,0
455,2.56925,3,0,41,0,71.039,3,8152,41,0,193,2,5.96994,1642,394,1758,0
538,3.03793,29,0,0,0,38.607,29,8189,0,0,264,0,4.49581,1642,394,1758,0
553,3.1214,37,0,0,0,59.775,37,8189,0,0,277,0,5.03237,1642,394,1758,0
570,3.21833,43,0,2,0,59.99,43,8189,2,0,248,2,4.71043,1644,396,1760,0
405,2.28671,26,0,44,0,48.466,26,8189,44,0,174,1,5.04931,1688,397,1804,0
551,3.11122,35,0,0,0,57.136,35,8189,0,0,277,0,4.39414,1688,397,1804,0
533,3.00963,39,0,3,0,57.778,41,8189,3,0,217,3,3.63166,1691,400,1807,0
442,2.49564,25,0,44,0,44.376,25,8189,44,0,175,2,4.29248,1735,402,1851,0
524,2.95855,33,0,0,0,48.591,33,8189,0,0,263,0,2.8127,1735,402,1851,0
488,2.7552,39,0,3,0,60.349,39,8189,3,0,197,3,2.63197,1738,405,1854,0
483,2.72732,43,0,4,0,59.255,43,8189,4,0,188,4,4.1061,1742,409,1858,0
479,2.70473,28,0,43,0,45.778,28,8189,43,0,210,0,3.43398,1785,409,1901,0
567,3.2016,37,0,1,0,66.561,37,8190,1,0,287,1,4.48451,1786,410,1902,0
495,2.79493,42,0,3,0,64.97,42,8189,3,0,193,3,5.00413,1789,413,1905,0
565,3.19019,47,0,3,0,63.553,47,8191,3,0,225,3,4.67654,1792,416,1908,0
598,3.3766,51,0,3,0,74.58,52,8190,3,0,256,3,4.77821,1795,419,1911,0
404,2.28122,27,0,58,0,39.201,27,8189,58,0,140,4,4.85728,1853,423,1969,0
485,2.73849,35,0,0,0,59.949,35,8189,0,0,245,0,5.12274,1853,423,1969,0
537,3.03211,41,0,3,0,57.064,41,8151,3,0,219,3,4.9307,1856,426,1972,0
525,2.96436,45,0,4,0,55.016,45,8189,4,0,187,4,5.3656,1860,430,1976,0
496,2.80044,50,0,1,0,91.316,50,8189,1,0,225,1,5.86827,1861,431,1977,0
528,2.98126,53,0,6,0,78.341,53,8189,6,0,195,6,5.84568,1867,437,1983,0
503,2.84014,57,0,4,0,93.57,57,8190,4,0,202,4,6.24669,1871,441,1987,0
527,2.97572,58,0,4,0,94.389,60,8189,4,0,185,4,5.95299,1875,445,1991,0
417,2.35463,9,0,70,0,83.161,9,8191,70,0,116,8,5.24699,1945,453,2061,0
569,3.21303,38,0,1,0,61.983,38,8191,1,0,276,1,6.2241,1946,454,2062,0
490,2.76683,42,0,3,0,81.892,42,8191,3,0,174,3,6.47261,1949,457,2065,0
410,2.31501,6,0,48,0,69.951,6,8191,48,0,143,3,6.19021,1997,460,2113,0
533,3.0095,31,0,0,0,49.695,31,8190,0,0,260,0,6.59686,1997,460,2113,0
559,3.15637,38,0,2,0,56.897,38,8189,2,0,251,2,6.72677,1999,462,2115,0
574,3.24111,44,0,1,0,64.759,44,8189,1,0,271,1,5.70448,2000,463,2116,0
541,3.05471,49,0,3,0,61.792,49,8189,3,0,206,3,5.15662,2003,466,2119,0
554,3.12793,53,0,5,0,85.47,53,8189,5,0,206,5,4.66525,2008,471,2124,0
468,2.64244,56,0,4,0,120.164,56,8190,4,0,187,4,4.0948,2012,475,2128,0
461,2.60294,31,0,59,0,50.371,31,8189,55,0,165,2,5.19616,2067,477,2187,0
559,3.15637,39,0,0,0,55.806,39,8189,0,0,282,0,5.99818,2067,477,2187,0
528,2.98136,43,0,4,0,63.66,43,8189,4,0,191,4,6.12243,2071,481,2191,0
493,2.78375,47,0,4,0,67.275,47,8189,4,0,189,4,4.86293,2075,485,2195,0
526,2.96989,3,0,54,0,86.737,3,8140,54,0,170,3,5.78355,2129,488,2249,0
182,1.02768,13,0,3,0,33.541,13,8189,3,0,91,0,5.90781,2132,488,2252,0
423,2.38865,24,0,0,0,49.918,24,8189,0,0,214,0,6.26363,2132,488,2252,0
548,3.0942,34,0,0,0,46.932,34,8189,0,0,274,0,6.39918,2132,488,2252,0
397,2.24169,22,0,36,0,35.246,22,8189,36,0,177,1,6.26363,2168,489,2288,0
538,3.0378,32,0,0,0,54.576,32,8189,0,0,271,0,6.03206,2168,489,2288,0
583,3.2917,40,0,0,0,59.432,40,8189,0,0,293,0,5.30347,2168,489,2288,0
565,3.19022,46,0,2,0,76.773,46,8189,2,0,246,2,4.84034,2170,491,2290,0
487,2.74976,50,0,3,0,77.21,50,8189,3,0,202,3,5.42208,2173,494,2293,0
524,2.95869,53,0,5,0,75.339,53,8189,5,0,167,5,5.62541,2178,499,2298,0
493,2.78366,30,0,56,0,46.527,30,8189,56,0,188,2,5.95864,2234,501,2354,0
508,2.86836,38,0,1,0,69.612,38,8189,1,0,255,1,5.99818,2235,502,2355,0
504,2.84578,42,0,3,0,71.724,42,8189,3,0,181,3,6.7889,2238,505,2358,0
570,3.21861,47,0,4,0,68.398,47,8189,4,0,204,4,4.13998,2242,509,2362,0
197,1.11237,10,0,51,0,35.356,10,8189,51,0,73,1,3.9423,2293,510,2413,0
371,2.09482,22,0,0,0,49.424,22,8189,0,0,187,0,4.61442,2293,510,2413,0
508,2.86855,31,0,0,0,44.968,31,8189,0,0,256,0,7.05435,2293,510,2413,0
568,3.20735,39,0,1,0,51.869,39,8189,1,0,268,1,4.28118,2294,511,2414,0
476,2.68767,44,0,4,0,75.069,44,8189,4,0,204,4,3.35491,2298,515,2418,0
497,2.80625,47,0,3,0,76.955,47,8189,3,0,165,3,3.20806,2301,518,2421,0
518,2.92473,51,0,4,0,92.209,51,8189,4,0,192,4,4.5184,2305,522,2425,0
563,3.17906,55,0,6,0,79.302,55,8189,6,0,184,6,5.58587,2311,528,2431,0
463,2.61431,32,0,56,0,55.735,32,8189,56,0,197,1,5.2131,2367,529,2487,0
380,2.14557,19,0,36,0,42.539,19,8189,36,0,155,2,4.89117,2403,531,2523,0
471,2.6594,29,0,0,0,67.595,29,8189,0,0,235,0,5.86262,2403,531,2523,0
546,3.08302,36,0,1,0,49.292,36,8187,1,0,257,1,6.29752,2404,532,2524,0
556,3.1395,42,0,3,0,69.881,42,8189,3,0,239,3,5.45597,2407,535,2527,0
544,3.07163,47,0,2,0,76.631,47,8190,2,0,217,2,5.68754,2409,537,2529,0
515,2.90797,51,0,5,0,86.41,51,8189,5,0,170,5,5.86827,2414,542,2534,0
538,3.03759,53,0,3,0,87.56,55,8189,3,0,221,3,5.34866,2417,545,2537,0
541,3.05485,58,0,5,0,67.504,58,8189,5,0,167,5,6.2128,2422,550,2542,0
564,3.18476,61,0,5,0,96.249,61,8189,5,0,198,5,7.6248,2427,555,2547,0
328,1.8521,31,0,64,0,56.609,31,8191,62,0,91,3,7.31981,2489,558,2611,0
487,2.74984,6,0,38,0,63.189,6,8189,38,0,225,1,5.84568,2527,559,2649,0
454,2.5635,27,0,0,0,37.053,27,8191,0,0,224,0,5.10579,2527,559,2649,0
569,3.21266,36,0,0,0,61.227,36,8189,0,0,288,0,5.38254,2527,559,2649,0
545,3.07729,42,0,4,0,67.218,42,8189,4,0,220,4,5.7892,2531,563,2653,0
562,3.17322,47,0,2,0,61.636,47,8189,2,0,241,2,6.64205,2533,565,2655,0
576,3.25225,51,0,4,0,62.627,51,8189,4,0,222,4,5.92475,2537,569,2659,0
522,2.9474,55,0,5,0,70.801,55,8190,5,0,188,5,4.21906,2542,574,2664,0
547,3.08861,58,0,5,0,90.561,58,8189,5,0,167,5,5.45597,2547,579,2669,0
574,3.24083,35,0,59,0,57.697,35,8189,59,0,245,1,6.68158,2606,580,2728,0
490,2.76682,40,0,4,0,65.046,40,8189,4,0,197,4,5.2357,2610,584,2732,0
517,2.91905,45,0,3,0,73.8,45,8189,3,0,222,3,4.47322,2613,587,2735,0
532,3.00392,49,0,4,0,66.715,49,8189,4,0,178,4,4.15693,2617,591,2739,0
566,3.1961,54,0,4,0,78.822,54,8191,4,0,237,4,5.88522,2621,595,2743,0
459,2.59185,30,0,56,0,49.534,30,8189,56,0,170,2,6.54603,2677,597,2799,0
483,2.72735,37,0,0,0,64.223,37,8191,0,0,245,0,5.83438,2677,597,2799,0
575,3.24543,44,0,1,0,64.667,44,8189,1,0,271,1,5.68754,2678,598,2800,0
404,2.28106,23,0,49,0,42.168,23,8189,49,0,130,3,5.60282,2727,601,2849,0
599,3.38207,34,0,0,0,45.1,34,8189,0,0,301,0,6.30882,2727,601,2849,0
490,2.76666,40,0,1,0,73.16,40,8189,1,0,233,1,6.30317,2728,602,2850,0
493,2.78374,44,0,4,0,63.854,44,8189,4,0,167,4,4.97589,2732,606,2854,0
551,3.11113,48,0,4,0,66.614,48,8190,4,0,214,4,4.6596,2736,610,2858,0
590,3.33129,53,0,3,0,67.298,53,8190,3,0,228,3,5.10579,2739,613,2861,0
565,3.19022,57,0,2,0,82.8,57,8189,2,0,207,2,4.91376,2741,615,2863,0
491,2.77231,60,0,6,0,92.171,60,8191,6,0,191,6,6.59122,2747,621,2869,0
577,3.2581,32,0,64,0,58.393,32,8191,59,0,195,3,5.68189,2806,624,2933,0
538,3.03725,39,0,1,0,71.737,39,8189,1,0,253,1,5.74402,2807,625,2934,0
543,3.06599,45,0,2,0,68.524,45,8190,2,0,256,2,5.0945,2809,627,2936,0
567,3.20171,49,0,3,0,80.283,49,8191,3,0,201,3,5.00978,2812,630,2939,0
515,2.90802,53,0,3,0,75.153,53,8189,3,0,188,3,4.3772,2815,633,2942,0
529,2.98699,56,0,5,0,97.218,56,8171,5,0,190,5,4.49016,2820,638,2947,0
496,2.80056,59,0,4,0,89.868,59,8190,4,0,168,4,5.06061,2824,642,2951,0
586,3.3087,55,0,8,0,80.618,62,8189,8,0,184,8,5.69318,2832,650,2959,0
557,3.1451,65,0,5,0,105.283,65,8189,5,0,155,5,5.90216,2837,655,2964,0
537,3.03228,53,0,5,0,90.77,67,8189,5,0,154,5,5.24699,2842,660,2969,0
596,3.36527,70,0,7,0,98.896,70,8174,7,0,194,7,5.5068,2849,667,2976,0
553,3.12239,70,0,8,0,111.296,72,8189,8,0,177,8,7.08259,2857,675,2984,0
406,2.29238,38,0,75,0,65.432,38,8189,61,0,157,2,6.98093,2918,677,3059,0
498,2.81142,43,0,3,0,51.697,43,8189,3,0,199,3,6.53474,2921,680,3062,0
530,2.99272,47,0,4,0,76.669,47,8189,4,0,181,4,6.24669,2925,684,3066,0
448,2.52978,50,0,3,0,74.113,50,8189,3,0,163,3,5.74966,2928,687,3069,0
526,2.97001,54,0,7,0,76.722,54,8189,7,0,193,7,7.38758,2935,694,3076,0
536,3.02646,57,0,4,0,94.672,57,8189,4,0,167,4,6.9301,2939,698,3080,0
543,3.06595,59,0,6,0,77.011,60,8189,6,0,191,6,5.15662,2945,704,3086,0
542,3.06032,35,0,62,0,51.707,35,8189,62,0,217,2,5.71013,3007,706,3148,0
515,2.90683,41,0,2,0,51.115,41,8189,2,0,226,2,4.03267,3009,708,3150,0
547,3.08847,47,0,1,0,69.126,47,8189,1,0,258,1,3.98749,3010,709,3151,0
539,3.04321,50,0,5,0,66.038,50,8189,5,0,184,5,6.0716,3015,714,3156,0
521,2.9417,9,0,56,0,76.349,9,8189,56,0,207,2,6.69853,3071,716,3212,0
560,3.16181,35,0,0,0,57.407,35,8191,0,0,271,0,4.82339,3071,716,3212,0
505,2.85131,40,0,2,0,89.734,40,8191,2,0,220,2,3.69944,3073,718,3214,0
424,2.39415,13,0,45,0,35.42,22,8189,45,0,170,2,4.91376,3118,720,3259,0
517,2.91927,31,0,0,0,56.558,31,8191,0,0,257,0,3.88018,3118,720,3259,0
578,3.26358,39,0,0,0,58.826,39,8191,0,0,292,0,3.97619,3118,720,3259,0
518,2.92483,45,0,2,0,67.862,45,8189,2,0,244,2,6.07725,3120,722,3261,0
465,2.62556,27,0,47,0,39.654,27,8191,47,0,181,1,7.22944,3167,723,3308,0
548,3.0942,36,0,0,0,54.952,36,8191,0,0,275,0,6.39354,3167,723,3308,0
452,2.55209,13,0,42,0,54.939,13,8189,42,0,185,2,4.96459,3209,725,3350,0
535,3.02077,30,0,0,0,52.008,30,8190,0,0,264,0,4.66525,3209,725,3350,0
583,3.29164,38,0,0,0,59.961,38,8189,0,0,292,0,6.0716,3209,725,3350,0
524,2.95867,43,0,3,0,66.534,43,8189,3,0,208,3,6.19021,3212,728,3353,0
486,2.74418,48,0,3,0,70.176,48,8189,3,0,201,3,4.02702,3215,731,3356,0
526,2.97011,51,0,4,0,88.969,51,8189,4,0,173,4,4.78386,3219,735,3360,0
511,2.88527,28,0,56,0,40.048,28,8189,56,0,196,3,4.01573,3275,738,3416,0
606,3.42186,37,0,0,0,59.046,37,8189,0,0,306,0,5.46162,3275,738,3416,0
539,3.04361,43,0,4,0,62.595,43,8189,4,0,237,4,5.67624,3279,742,3420,0
552,3.11679,47,0,3,0,75.349,47,8189,3,0,193,3,5.56893,3282,745,3423,0
533,3.00951,51,0,4,0,75.084,51,8189,4,0,174,4,5.74402,3286,749,3427,0
527,2.97559,52,0,5,0,76.438,54,8189,5,0,191,5,6.57427,3291,754,3432,0
516,2.91352,58,0,4,0,78.413,58,8189,4,0,179,4,6.2015,3295,758,3436,0
560,3.16182,61,0,6,0,93.944,61,8189,6,0,199,6,5.40514,3301,764,3442,0
541,3.05469,64,0,5,0,94.658,64,8189,5,0,184,5,6.54603,3306,769,3447,0
505,2.85162,66,0,9,0,91.181,66,8191,9,0,160,9,6.47826,3315,778,3456,0
477,2.69354,37,0,67,0,62.867,37,8189,64,0,195,2,5.38819,3379,780,3523,0
381,2.15132,21,0,42,0,62.648,21,8189,42,0,148,2,5.42208,3421,782,3565,0
545,3.07736,31,0,0,0,54.765,31,8189,0,0,274,0,6.4952,3421,782,3565,0
563,3.17882,39,0,1,0,55.893,39,8190,1,0,283,1,7.06,3422,783,3566,0
534,3.01523,44,0,2,0,57.85,44,8189,2,0,211,2,5.47856,3424,785,3568,0
452,2.5522,28,0,45,0,41.719,28,8189,45,0,199,1,4.57488,3469,786,3613,0
569,3.21294,36,0,1,0,64.065,36,8190,1,0,271,1,4.89117,3470,787,3614,0
549,3.10009,43,0,2,0,60.105,43,8189,2,0,242,2,6.26928,3472,789,3616,0
534,3.01509,47,0,4,0,78.626,47,8191,4,0,204,4,6.02077,3476,793,3620,0
557,3.14508,51,0,3,0,78.765,51,8191,3,0,211,3,5.77226,3479,796,3623,0
562,3.1733,55,0,6,0,81.631,55,8191,6,0,207,6,4.46757,3485,802,3629,0
541,3.05469,57,0,5,0,85.827,58,8187,5,0,167,5,5.03237,3490,807,3634,0
572,3.22977,58,0,5,0,85.28,61,8166,5,0,202,5,4.8121,3495,812,3639,0
499,2.81759,64,0,5,0,77.285,64,8191,5,0,161,5,5.60846,3500,817,3644,0
467,2.63693,66,0,4,0,100.773,66,8190,4,0,143,4,6.7776,3504,821,3648,0
469,2.64824,37,0,66,0,62.241,37,8189,58,0,192,0,7.29157,3562,821,3714,0
564,3.18476,43,0,2,0,62.515,43,8189,2,0,246,2,6.72677,3564,823,3716,0
519,2.93085,47,0,4,0,62.165,47,8189,4,0,197,4,5.31477,3568,827,3720,0
558,3.15089,52,0,4,0,74.33,52,8191,4,0,210,4,4.5184,3572,831,3724,0
548,3.09423,55,0,4,0,72.337,55,8189,4,0,201,4,6.47261,3576,835,3728,0
592,3.34276,59,0,5,0,74.315,59,8191,5,0,215,5,6.75501,3581,840,3733,0
547,3.08847,62,0,5,0,93.265,62,8191,5,0,162,5,6.04336,3586,845,3738,0
498,2.81199,64,0,7,0,77.067,64,8191,7,0,162,7,5.59717,3593,852,3745,0
407,2.29819,35,0,64,0,71.309,35,8191,59,0,162,0,6.13938,3652,852,3809,0
630,3.55748,43,0,2,0,54.966,43,8189,2,0,295,2,5.57458,3654,854,3811,0
549,3.09989,48,0,3,0,82.268,48,8189,3,0,214,3,6.02077,3657,857,3814,0
558,3.15089,51,0,7,0,77.522,51,8189,7,0,189,7,6.59686,3664,864,3821,0
572,3.22976,54,0,3,0,74.15,55,8189,3,0,215,3,6.15632,3667,867,3824,0
572,3.22942,59,0,3,0,106.034,59,8189,3,0,209,3,6.3653,3670,870,3827,0
512,2.89089,60,0,6,0,88.103,61,8133,6,0,141,6,6.82843,3676,876,3833,0
568,3.20669,64,0,2,0,78.026,65,8189,2,0,228,2,5.87392,3678,878,3835,0
475,2.68208,36,0,67,0,50.928,36,8189,67,0,192,2,5.71578,3745,880,3902,0
399,2.25286,20,0,41,0,37.27,20,8189,41,0,173,1,5.57458,3786,881,3943,0
497,2.80612,30,0,0,0,49.036,30,8189,0,0,249,0,5.78355,3786,881,3943,0
457,2.58055,5,0,38,0,59.664,5,8189,38,0,193,2,5.42208,3824,883,3981,0
377,2.12854,25,0,0,0,49.015,25,8189,0,0,186,0,5.28088,3824,883,3981,0
550,3.1057,34,0,1,0,48.597,34,8189,1,0,265,1,4.74997,3825,884,3982,0
564,3.18449,41,0,2,0,55.439,41,8189,2,0,266,2,4.27554,3827,886,3984,0
525,2.96436,46,0,2,0,72.026,46,8146,2,0,202,2,4.41109,3829,888,3986,0
529,2.98681,50,0,3,0,93.446,50,8191,3,0,199,3,4.12304,3832,891,3989,0
443,2.50138,30,0,51,0,45.058,30,8189,51,0,189,1,3.74462,3883,892,4040,0
440,2.48437,17,0,36,0,47.214,17,8191,36,0,197,1,4.48451,3919,893,4076,0
503,2.84014,28,0,0,0,40.859,28,8191,0,0,251,0,4.70478,3919,893,4076,0
543,3.066,36,0,1,0,67.423,36,8189,1,0,262,1,4.88552,3920,894,4077,0
556,3.13935,42,0,2,0,74.688,42,8189,2,0,243,2,5.15662,3922,896,4079,0
558,3.1505,48,0,2,0,62.416,48,8189,2,0,260,2,4.35461,3924,898,4081,0
537,3.03211,52,0,4,0,80.197,52,8190,4,0,204,4,5.77226,3928,902,4085,0
540,3.04915,56,0,4,0,81.441,56,8190,4,0,197,4,6.25234,3932,906,4089,0
519,2.93042,58,0,4,0,78.939,58,8189,4,0,153,4,6.07725,3936,910,4093,0
549,3.0998,61,0,7,0,88.594,61,8166,7,0,145,7,5.99818,3943,917,4100,0
547,3.08877,63,0,68,0,78.987,2,8191,68,0,156,5,5.24134,4011,922,4168,0
505,2.85155,37,0,1,0,56.746,37,8191,1,0,243,1,5.85698,4012,923,4169,0
506,2.85704,42,0,3,0,101.093,42,8189,3,0,218,3,6.27493,4015,926,4172,0
629,3.5516,48,0,3,0,73.826,48,8189,3,0,255,3,5.64235,4018,929,4175,0
539,3.0434,25,0,53,0,41.09,25,8190,53,0,215,2,5.4955,4071,931,4228,0
356,2.01019,16,0,30,0,42.964,16,8189,30,0,158,1,5.48986,4101,932,4258,0
458,2.58592,26,0,0,0,53.628,26,8189,0,0,231,0,4.74432,4101,932,4258,0
555,3.13374,35,0,0,0,55.422,35,8189,0,0,281,0,4.86293,4101,932,4258,0
525,2.96431,41,0,2,0,74.373,41,8189,2,0,225,2,4.34331,4103,934,4260,0
529,2.98712,46,0,4,0,72.383,46,8189,4,0,205,4,3.76722,4107,938,4264,0
490,2.76669,50,0,4,0,73.645,50,8189,4,0,183,4,4.98154,4111,942,4268,0
577,3.25789,53,0,7,0,85.649,53,8174,7,0,193,7,5.29782,4118,949,4275,0
477,2.69327,56,0,5,0,78.96,56,8190,5,0,162,5,4.72738,4123,954,4280,0
581,3.28057,60,0,3,0,87.55,60,8189,3,0,211,3,6.82843,4126,957,4283,0
505,2.85131,61,0,5,0,88.923,63,8189,5,0,166,5,7.41582,4131,962,4288,0
567,3.20125,64,0,4,0,101.955,65,8191,4,0,191,4,6.57427,4135,966,4292,0
535,3.02077,68,0,6,0,98.938,68,8189,6,0,173,6,6.57427,4141,972,4298,0
535,3.02077,70,0,5,0,103.822,70,8189,5,0,154,5,5.61976,4146,977,4303,0
588,3.31989,73,0,6,0,101.643,73,8159,6,0,169,6,4.56923,4152,983,4309,0
499,2.81753,38,0,78,0,63.361,38,8191,63,0,152,4,5.23005,4215,987,4387,0
531,2.99826,43,0,2,0,61.253,43,8189,2,0,230,2,6.70982,4217,989,4389,0
550,3.10548,48,0,5,0,64.776,48,8190,5,0,214,5,5.83438,4222,994,4394,0
562,3.1733,52,0,5,0,72.174,52,8190,5,0,189,5,5.59152,4227,999,4399,0
467,2.63681,27,0,56,0,43.112,27,8191,56,0,147,2,4.91941,4283,1001,4455,0
569,3.21279,36,0,0,0,63.427,36,8189,0,0,287,0,4.9533,4283,1001,4455,0
591,3.33698,43,0,1,0,64.924,43,8189,1,0,280,1,5.28088,4284,1002,4456,0
567,3.20141,47,0,3,0,69.384,48,8189,3,0,222,3,5.61976,4287,1005,4459,0
562,3.17357,52,0,4,0,78.178,52,8189,4,0,214,4,5.32606,4291,1009,4463,0
570,3.21854,56,0,4,0,86.314,56,8189,4,0,211,4,4.96459,4295,1013,4467,0
544,3.07139,34,0,57,0,49.92,34,8189,57,0,232,1,4.11174,4352,1014,4524,0
532,3.00348,41,0,0,0,89.434,41,8189,0,0,270,0,4.47886,4352,1014,4524,0
593,3.34829,47,0,1,0,64.944,47,8189,1,0,276,1,5.52374,4353,1015,4525,0
575,3.24655,51,0,4,0,69.436,51,8189,4,0,199,4,5.68189,4357,1019,4529,0
556,3.13935,55,0,4,0,81.691,55,8189,4,0,204,4,5.53504,4361,1023,4533,0
531,2.99836,58,0,5,0,82.617,58,8189,5,0,185,5,5.24134,4366,1028,4538,0
618,3.4894,57,0,4,0,76.825,62,8189,4,0,228,4,6.47826,4370,1032,4542,0
533,3.00948,65,0,6,0,96.48,65,8190,6,0,179,6,6.24669,4376,1038,4548,0
558,3.15066,68,0,4,0,107.165,68,8189,4,0,188,4,6.83973,4380,1042,4552,0
616,3.47801,68,0,6,0,96.879,70,8189,6,0,195,6,8.91819,4386,1048,4558,0
597,3.37063,57,0,7,0,105.872,73,8189,7,0,172,7,7.06565,4393,1055,4565,0
544,3.0717,50,0,6,0,100.838,75,8189,6,0,171,6,6.54603,4399,1061,4571,0
561,3.16775,77,0,5,0,101.929,77,8189,5,0,148,5,5.70448,4404,1066,4576,0
426,2.40542,40,0,78,0,62.535,40,8189,60,0,151,1,4.19082,4464,1067,4654,0
514,2.90232,45,0,4,0,62.931,45,8189,4,0,198,4,4.65395,4468,1071,4658,0
559,3.15585,49,0,5,0,69.356,49,8189,5,0,196,5,6.21845,4473,1076,4663,0
432,2.43921,7,0,55,0,78.785,7,8189,55,0,140,3,5.89086,4528,1079,4718,0
490,2.7666,33,0,1,0,61.114,33,8189,1,0,226,1,3.91406,4529,1080,4719,0
550,3.1056,40,0,0,0,81.005,40,8189,0,0,275,0,3.92536,4529,1080,4719,0
569,3.21279,45,0,4,0,68.812,45,8189,4,0,226,4,6.5065,4533,1084,4723,0
540,3.04907,50,0,4,0,72.976,50,8187,4,0,204,4,7.29722,4537,1088,4727,0
587,3.31431,54,0,5,0,78.159,54,8189,5,0,223,5,6.85102,4542,1093,4732,0
533,3.00951,57,0,5,0,76.071,57,8189,5,0,188,5,5.31477,4547,1098,4737,0
493,2.78355,32,0,60,0,50.152,32,8191,60,0,178,2,3.60907,4607,1100,4797,0
576,3.25221,40,0,0,0,76.389,40,8189,0,0,288,0,4.62571,4607,1100,4797,0
537,3.03216,45,0,3,0,68.868,45,8191,3,0,213,3,5.88522,4610,1103,4800,0
549,3.09971,49,0,4,0,75.898,49,8189,4,0,210,4,4.68219,4614,1107,4804,0
561,3.16749,53,0,5,0,71.757,53,8191,5,0,185,5,5.32042,4619,1112,4809,0
557,3.14502,56,0,3,0,88.49,57,8189,3,0,203,3,5.61976,4622,1115,4812,0
577,3.25791,59,0,6,0,89.25,60,8190,6,0,207,6,5.93605,4628,1121,4818,0
606,3.42182,63,0,4,0,92.519,64,8189,3,0,219,4,6.51779,4631,1125,4822,0
539,3.04327,65,0,7,0,97.984,66,8189,8,0,179,7,7.7547,4639,1132,4829,0
545,3.07738,68,0,7,0,80.029,68,8189,7,0,146,7,7.16731,4646,1139,4836,0
529,2.98681,65,0,7,0,102.729,71,8189,6,0,141,7,4.88552,4652,1146,4843,0
553,3.12262,63,0,5,0,83.998,72,8189,6,0,143,5,4.29813,4658,1151,4848,0
543,3.06603,73,0,6,0,107.834,75,8189,6,0,154,6,6.45566,4664,1157,4854,0
629,3.55152,73,0,4,0,114.969,77,8189,4,0,222,4,6.19021,4668,1161,4858,0
557,3.14491,80,0,8,0,92.432,80,8189,8,0,162,8,6.24669,4676,1169,4866,0
610,3.44444,80,0,6,0,84.006,82,8189,6,0,182,6,6.72677,4682,1175,4872,0
581,3.28054,70,0,9,0,119.646,83,8189,9,0,140,9,4.95894,4691,1184,4881,0
368,2.07785,13,0,91,0,85.385,13,8189,65,0,75,7,4.95894,4756,1191,4972,0
463,2.61429,24,0,44,0,38.931,24,8189,44,0,190,1,4.39414,4800,1192,5016,0
525,2.96413,33,0,0,0,50.264,33,8189,0,0,262,0,3.68814,4800,1192,5016,0
620,3.50079,41,0,1,0,53.555,41,8189,1,0,295,1,4.61442,4801,1193,5017,0
597,3.37092,46,0,2,0,57.506,47,8190,2,0,262,2,5.42208,4803,1195,5019,0
566,3.1957,51,0,4,0,76.284,51,8189,4,0,194,4,6.14502,4807,1199,5023,0
527,2.97569,52,0,6,0,76.265,54,8189,6,0,167,6,4.60312,4813,1205,5029,0
575,3.24666,58,0,3,0,100.072,58,8189,3,0,215,3,3.78981,4816,1208,5032,0
429,2.42227,31,0,62,0,50.951,31,8189,14,0,173,3,3.66555,4830,1211,5094,0
555,3.13386,39,0,0,0,53.369,39,8189,0,0,277,0,4.76126,4830,1211,5094,0
594,3.35394,45,0,2,0,70.331,45,8189,2,0,261,2,5.71013,4832,1213,5096,0
441,2.49015,24,0,49,0,43.49,24,8189,49,0,169,2,5.05496,4881,1215,5145,0
579,3.26953,34,0,0,0,47.935,34,8189,0,0,290,0,4.82904,4881,1215,5145,0
548,3.09439,41,0,1,0,81.515,41,8189,1,0,258,1,5.38819,4882,1216,5146,0
568,3.2073,47,0,2,0,80.429,47,8190,2,0,267,2,7.17296,4884,1218,5148,0
457,2.58057,28,0,49,0,52.781,28,8189,49,0,175,1,7.02046,4933,1219,5197,0
556,3.13963,36,0,0,0,61.487,36,8189,0,0,281,0,5.74966,4933,1219,5197,0
395,2.23026,23,0,39,0,51.512,23,8189,39,0,172,1,4.52405,4972,1220,5236,0
578,3.26364,33,0,0,0,55.224,33,8185,0,0,291,0,4.68219,4972,1220,5236,0
425,2.39966,19,0,38,0,50.013,19,8189,38,0,189,1,5.21875,5010,1221,5274,0
473,2.67072,29,0,0,0,56.17,29,8189,0,0,237,0,4.9307,5010,1221,5274,0
601,3.39342,38,0,0,0,61.858,38,8189,0,0,301,0,5.06626,5010,1221,5274,0
611,3.44994,44,0,2,0,65.467,44,8189,2,0,269,2,5.00413,5012,1223,5276,0
559,3.15637,50,0,1,0,92.427,50,8189,1,0,262,1,5.26394,5013,1224,5277,0
568,3.20715,54,0,2,0,84.813,54,8189,2,0,241,2,4.84034,5015,1226,5279,0
511,2.88536,58,0,4,0,108.917,58,8189,4,0,205,4,5.69318,5019,1230,5283,0
539,3.04333,61,0,5,0,81.448,61,8189,5,0,158,5,5.59152,5024,1235,5288,0
561,3.16768,57,0,3,0,90.428,64,8189,3,0,194,3,6.81149,5027,1238,5291,0
541,3.05465,66,0,6,0,92.096,66,8189,6,0,176,6,5.57458,5033,1244,5297,0
626,3.53459,66,0,5,0,101.748,70,8189,5,0,221,5,5.15662,5038,1249,5302,0
614,3.46691,69,0,4,0,103.389,73,8189,4,0,207,4,5.99253,5042,1253,5306,0
563,3.17886,74,0,8,0,89.233,75,8189,8,0,178,8,5.23005,5050,1261,5314,0
426,2.40534,25,0,78,0,52.164,25,8189,62,0,105,2,5.63106,5112,1263,5392,0
572,3.22987,43,0,3,0,61.442,43,8148,3,0,223,3,5.96994,5115,1266,5395,0
488,2.75286,27,0,45,0,45.316,27,8189,45,0,213,1,5.15098,5160,1267,5440,0
539,3.0434,35,0,0,0,46.047,35,8189,0,0,271,0,6.15067,5160,1267,5440,0
509,2.87397,42,0,0,0,69.455,42,8189,0,0,257,0,5.33171,5160,1267,5440,0
597,3.37087,48,0,3,0,90.423,48,8189,3,0,260,3,4.64266,5163,1270,5443,0
568,3.20732,51,0,4,0,78.841,51,8189,4,0,191,4,4.55794,5167,1274,5447,0
510,2.87937,55,0,3,0,79.966,55,8189,3,0,208,3,3.88582,5170,1277,5450,0
574,3.24103,59,0,4,0,91.027,59,8190,4,0,234,4,4.97589,5174,1281,5454,0
581,3.28065,62,0,6,0,90.565,62,8189,6,0,176,6,5.3656,5180,1287,5460,0
599,3.38208,63,0,3,0,103.414,66,8187,3,0,241,3,6.60251,5183,1290,5463,0
554,3.12803,65,0,5,0,94.339,69,8189,5,0,184,5,6.19586,5188,1295,5468,0
552,3.11677,67,0,4,0,111.622,71,8189,4,0,178,4,3.59213,5192,1299,5472,0
531,2.99817,73,0,7,0,107.824,73,8190,7,0,162,7,3.42269,5199,1306,5479,0
597,3.37107,70,0,6,0,91.823,76,8189,6,0,167,6,5.06061,5205,1312,5485,0
568,3.20719,58,0,6,0,93.288,78,8189,6,0,149,6,4.85163,5211,1318,5491,0
577,3.25804,67,0,5,0,97.515,79,8189,5,0,144,5,5.25264,5216,1323,5496,0
639,3.60813,82,0,5,0,104.837,82,8190,5,0,206,5,7.88461,5221,1328,5501,0
574,3.24115,84,0,7,0,128.699,84,8189,7,0,168,7,7.28592,5228,1335,5508,0
586,3.3086,86,0,9,0,119.588,86,8191,9,0,171,9,5.30912,5237,1344,5517,0
618,3.48963,59,0,7,0,108.186,88,8191,7,0,159,7,5.82874,5244,1351,5524,0
429,2.42239,6,0,135,0,67.876,6,8191,108,0,129,3,6.13373,5352,1354,5659,0
518,2.92486,30,0,0,0,64.002,30,8189,0,0,253,0,6.13938,5352,1354,5659,0
554,3.12822,38,0,1,0,56.139,38,8189,1,0,262,1,5.40514,5353,1355,5660,0
441,2.49016,22,0,42,0,52.226,23,8189,42,0,193,1,4.39979,5395,1356,5702,0
580,3.27493,33,0,0,0,57.693,33,8189,0,0,292,0,4.90246,5395,1356,5702,0
532,3.00388,39,0,2,0,59.074,39,8189,2,0,233,2,6.13938,5397,1358,5704,0
423,2.38844,25,0,41,0,41.904,25,8189,41,0,187,1,6.41613,5438,1359,5745,0
514,2.90168,34,0,0,0,55.524,34,8189,0,0,258,0,7.08824,5438,1359,5745,0
616,3.47838,42,0,0,0,53.479,42,8189,0,0,313,0,7.98627,5438,1359,5745,0
611,3.45004,48,0,2,0,60.77,48,8189,2,0,268,2,7.4836,5440,1361,5747,0
487,2.74989,27,0,52,0,40.223,27,8189,50,0,189,2,6.32011,5490,1363,5799,0
467,2.63681,34,0,1,0,71.183,34,8158,1,0,221,1,5.9417,5491,1364,5800,0
451,2.54641,11,0,40,0,52.336,11,8191,40,0,202,1,4.85728,5531,1365,5840,0
433,2.4451,27,0,0,0,38.635,27,8189,0,0,215,0,4.27554,5531,1365,5840,0
540,3.04929,36,0,1,0,64.966,36,8189,1,0,271,1,4.62571,5532,1366,5841,0
515,2.90826,42,0,0,0,120.628,42,8189,0,0,245,0,5.46162,5532,1366,5841,0
517,2.91927,48,0,0,0,68.08,48,8189,0,0,262,0,6.02642,5532,1366,5841,0
546,3.08292,52,0,3,0,76.236,52,8191,3,0,201,3,6.00382,5535,1369,5844,0
550,3.10547,56,0,1,0,88.969,56,8191,1,0,253,1,4.21341,5536,1370,5845,0
358,2.02139,31,0,57,0,48.592,31,8189,57,0,143,1,3.94795,5593,1371,5902,0
466,2.63119,38,0,1,0,104.32,38,8191,1,0,224,1,6.07725,5594,1372,5903,0
519,2.93042,44,0,1,0,74.087,44,8191,1,0,241,1,8.47765,5595,1373,5904,0
553,3.12243,49,0,2,0,91.763,49,8191,2,0,234,2,7.83378,5597,1375,5906,0
584,3.29749,53,0,3,0,71.027,53,8191,3,0,224,3,6.66464,5600,1378,5909,0
579,3.2693,57,0,3,0,83.407,57,8191,3,0,213,3,7.74906,5603,1381,5912,0
356,2.01021,29,0,58,0,87.518,31,8189,58,0,140,1,6.66464,5661,1382,5970,0
456,2.57445,38,0,0,0,58.685,38,8191,0,0,233,0,4.3772,5661,1382,5970,0
531,2.99816,21,0,44,0,103.856,21,8191,44,0,237,1,5.06626,5705,1383,6014,0
510,2.8798,31,0,0,0,43.616,31,8189,0,0,255,0,5.648,5705,1383,6014,0
475,2.68198,38,0,0,0,58.547,38,8191,0,0,240,0,4.77256,5705,1383,6014,0
545,3.07721,43,0,2,0,58.866,43,8191,2,0,236,2,4.84598,5707,1385,6016,0
488,2.75533,4,0,54,0,73.308,2,8189,54,0,197,2,4.03832,5761,1387,6070,0
136,0.76789,12,0,0,0,51.943,12,8189,0,0,71,0,5.33171,5761,1387,6070,0
296,1.67125,21,0,0,0,41.05,21,8189,0,0,152,0,6.44437,5761,1387,6070,0
412,2.32628,29,0,0,0,50.477,29,8189,0,0,207,0,6.76066,5761,1387,6070,0
432,2.43921,36,0,0,0,61.289,36,8191,0,0,220,0,5.40514,5761,1387,6070,0
496,2.80072,41,0,3,0,79.376,41,8191,3,0,215,3,5.53504,5764,1390,6073,0
522,2.94736,47,0,0,0,95.822,47,8189,0,0,246,0,6.0603,5764,1390,6073,0
582,3.28614,52,0,2,0,86.867,52,8189,2,0,251,2,4.69349,5766,1392,6075,0
526,2.97005,54,0,3,0,79.386,55,8189,3,0,192,3,4.12304,5769,1395,6078,0
558,3.15069,59,0,4,0,84.633,59,8189,4,0,197,4,5.50115,5773,1399,6082,0
433,2.445,3,0,68,0,79.506,3,8189,68,0,132,3,6.09984,5841,1402,6150,0
224,1.26487,15,0,0,0,30.78,15,8189,0,0,114,0,5.76661,5841,1402,6150,0
469,2.64826,26,0,0,0,41.079,26,8189,0,0,238,0,4.89117,5841,1402,6150,0
465,2.62577,34,0,0,0,48.822,34,8189,0,0,231,0,4.31507,5841,1402,6150,0
514,2.90227,40,0,1,0,66.721,40,8189,1,0,242,1,4.34896,5842,1403,6151,0
631,3.56258,47,0,1,0,62.806,47,8189,1,0,302,1,4.11174,5843,1404,6152,0
390,2.20208,5,0,52,0,85.15,5,8189,52,0,169,1,5.41643,5895,1405,6204,0
312,1.76177,29,0,0,0,52.893,29,8191,0,0,151,0,5.55198,5895,1405,6204,0
401,2.26425,36,0,0,0,63.12,36,8191,0,0,206,0,5.60282,5895,1405,6204,0
580,3.2747,42,0,1,0,59.135,42,8187,1,0,274,1,5.74966,5896,1406,6205,0
580,3.27486,48,0,2,0,76.832,48,8189,2,0,251,2,5.73272,5898,1408,6207,0
493,2.78364,26,0,54,0,37.083,26,8191,54,0,190,3,7.0713,5952,1411,6261,0
509,2.87396,34,0,0,0,60.882,34,8189,0,0,257,0,5.95864,5952,1411,6261,0
552,3.1169,4,0,42,0,55.693,4,8165,42,0,257,1,4.12304,5994,1412,6303,0
287,1.62051,25,0,0,0,79.949,25,8189,0,0,139,0,3.91406,5994,1412,6303,0
533,3.00963,34,0,0,0,59.267,34,8191,0,0,267,0,3.73333,5994,1412,6303,0
494,2.78948,40,0,1,0,59.493,40,8189,1,0,231,1,4.90246,5995,1413,6304,0
567,3.20152,46,0,2,0,65.435,46,8191,2,0,244,2,6.31446,5997,1415,6306,0
568,3.20708,50,0,5,0,78.067,50,8157,5,0,206,5,4.15693,6002,1420,6311,0
546,3.08286,54,0,4,0,76.865,54,8191,4,0,195,4,3.8124,6006,1424,6315,0
534,3.01321,4,0,61,0,74.95,4,8164,61,0,190,4,6.32011,6067,1428,6376,0
415,2.34245,33,0,0,0,51.242,33,8191,0,0,198,0,6.57992,6067,1428,6376,0
484,2.73284,40,0,0,0,72.517,40,8189,0,0,245,0,5.13968,6067,1428,6376,0
474,2.67645,45,0,1,0,87.876,45,8189,1,0,222,1,5.03802,6068,1429,6377,0
429,2.42208,29,0,45,0,43.976,29,8189,45,0,207,0,5.20181,6113,1429,6422,0
592,3.34275,38,0,0,0,46.246,38,8189,0,0,297,0,3.88582,6113,1429,6422,0
572,3.22974,44,0,2,0,67.821,44,8189,2,0,252,2,4.58618,6115,1431,6424,0
525,2.96424,49,0,2,0,59.982,49,8189,2,0,223,2,5.03802,6117,1433,6426,0
528,2.98126,53,0,2,0,76.222,53,8189,2,0,219,2,5.2131,6119,1435,6428,0
624,3.52349,53,0,4,0,68.255,57,8189,4,0,220,4,5.0719,6123,1439,6432,0
379,2.13995,30,0,58,0,48.573,30,8191,58,0,151,1,3.8237,6181,1440,6490,0
385,2.17353,36,0,0,0,89.339,36,8189,0,0,194,0,4.68219,6181,1440,6490,0
497,2.80617,42,0,1,0,78.895,42,8191,1,0,234,1,5.50115,6182,1441,6491,0
428,2.41659,22,0,48,0,64.858,22,8189,26,0,175,2,6.25234,6208,1443,6539,0
287,1.62056,19,0,22,0,75.095,19,8191,22,0,142,0,5.6367,6230,1443,6561,0
375,2.1174,27,0,0,0,38.674,27,8191,0,0,188,0,5.67059,6230,1443,6561,0
561,3.16647,34,0,0,0,57.84,36,8189,0,0,285,0,5.19051,6230,1443,6561,0
571,3.22419,42,0,2,0,54.931,42,8189,2,0,251,2,7.24074,6232,1445,6563,0
596,3.36515,48,0,2,0,66.217,48,8189,2,0,264,2,6.3653,6234,1447,6565,0
566,3.19596,50,0,2,0,87.465,53,8189,2,0,243,2,5.04931,6236,1449,6567,0
408,2.30367,29,0,55,0,67.956,29,8189,55,0,167,1,4.49016,6291,1450,6622,0
498,2.81166,36,0,1,0,84.584,36,8189,1,0,235,1,4.94765,6292,1451,6623,0
523,2.95307,42,0,2,0,65.948,42,8191,2,0,227,2,4.98718,6294,1453,6625,0
432,2.43805,22,0,47,0,44.302,22,8191,47,0,164,2,4.20211,6341,1455,6672,0
536,3.02642,32,0,0,0,47.835,32,8189,0,0,268,0,4.11174,6341,1455,6672,0
544,3.07155,39,0,0,0,84.872,39,8189,0,0,274,0,4.37155,6341,1455,6672,0
430,2.42764,23,0,43,0,31.281,23,8191,43,0,185,1,4.62571,6384,1456,6715,0
545,3.07586,33,0,0,0,52.867,33,8189,0,0,273,0,5.37125,6384,1456,6715,0
477,2.69348,22,0,36,0,35.263,22,8189,36,0,231,0,5.63106,6420,1456,6751,0
532,3.00379,31,0,0,0,43.556,32,8190,0,0,269,0,5.87392,6420,1456,6751,0
558,3.14772,40,0,0,0,60.428,40,8189,0,0,279,0,5.95299,6420,1456,6751,0
493,2.78356,45,0,2,0,83.722,45,8189,2,0,207,2,5.3656,6422,1458,6753,0
579,3.26934,49,0,3,0,63.125,49,8189,3,0,226,3,4.76691,6425,1461,6756,0
447,2.52395,26,0,54,0,44.233,26,8189,54,0,168,3,5.84568,6479,1464,6810,0
553,3.122,35,0,0,0,65.681,35,8189,0,0,278,0,6.13938,6479,1464,6810,0
483,2.72725,41,0,1,0,80.619,41,8191,1,0,223,1,6.29752,6480,1465,6811,0
505,2.8512,47,0,0,0,92.959,47,8189,0,0,256,0,6.78325,6480,1465,6811,0
534,3.01518,51,0,2,0,107.252,51,8189,2,0,225,2,6.0603,6482,1467,6813,0
582,3.28628,55,0,4,0,85.492,55,8189,4,0,216,4,6.0716,6486,1471,6817,0
550,3.10545,59,0,5,0,86.217,59,8189,5,0,194,5,5.73272,6491,1476,6822,0
512,2.89104,61,0,4,0,92.052,61,8189,4,0,172,4,6.08854,6495,1480,6826,0
577,3.25648,60,0,4,0,106.665,65,8189,4,0,203,4,5.74402,6499,1484,6830,0
582,3.28614,68,0,5,0,92.69,68,8189,5,0,196,5,6.81714,6504,1489,6835,0
554,3.12804,61,0,5,0,94.83,70,8191,5,0,152,5,6.57992,6509,1494,6840,0
528,2.98124,69,0,7,0,100.492,72,8189,7,0,159,7,5.98688,6516,1501,6847,0
601,3.39343,71,0,6,0,104.879,75,8189,6,0,197,6,5.69883,6522,1507,6853,0
612,3.45553,77,0,6,0,101.317,77,8189,6,0,195,6,5.32042,6528,1513,6859,0
544,3.07148,79,0,6,0,96.362,79,8189,6,0,163,6,6.17891,6534,1519,6865,0
414,2.33743,6,0,86,0,111.377,6,8189,86,0,127,5,6.80019,6620,1524,6951,0
457,2.58044,43,0,3,0,62.955,43,8190,3,0,196,3,7.03176,6623,1527,6954,0
580,3.27511,49,0,3,0,78.605,49,8181,3,0,249,3,8.0484,6626,1530,6957,0
468,2.64272,51,0,4,0,70.509,52,8189,4,0,167,4,7.45536,6630,1534,6961,0
534,3.01507,28,0,57,0,34.463,28,8189,26,0,223,2,6.17326,6656,1536,7018,0
496,2.80047,36,0,0,0,54.348,36,8189,0,0,250,0,4.73302,6656,1536,7018,0
403,2.27551,25,0,37,0,39.013,25,8189,37,0,176,1,4.42238,6693,1537,7055,0
503,2.84009,33,0,0,0,48.3,33,8189,0,0,255,0,4.75562,6693,1537,7055,0
504,2.84572,40,0,0,0,57.297,40,8189,0,0,257,0,6.73242,6693,1537,7055,0
565,3.1902,46,0,2,0,64.769,46,8191,2,0,243,2,7.63045,6695,1539,7057,0
567,3.20144,50,0,3,0,76.131,50,8189,3,0,220,3,5.96429,6698,1542,7060,0
546,3.08282,55,0,2,0,78.749,55,8191,2,0,227,2,7.56832,6700,1544,7062,0
593,3.34827,59,0,2,0,74.391,59,8191,2,0,249,2,6.00382,6702,1546,7064,0
543,3.06615,58,0,4,0,96.335,62,8189,4,0,189,4,6.57992,6706,1550,7068,0
506,2.85699,59,0,5,0,82.476,64,8189,5,0,136,5,6.87926,6711,1555,7073,0
523,2.95317,67,0,8,0,95.61,67,8189,8,0,201,8,6.24669,6719,1563,7081,0
555,3.13392,62,0,4,0,118.217,70,8189,4,0,186,4,5.46726,6723,1567,7085,0
570,3.21856,73,0,5,0,113.038,73,8188,5,0,217,5,5.58587,6728,1572,7090,0
460,2.59721,75,0,5,0,112.297,75,8189,5,0,160,5,7.15602,6733,1577,7095,0
584,3.29742,41,0,77,0,53.441,41,8191,77,0,202,1,8.15006,6810,1578,7172,0
533,3.00948,45,0,4,0,65.285,45,8189,4,0,209,4,8.81653,6814,1582,7176,0
536,3.02655,51,0,1,0,76.389,51,8189,1,0,248,1,8.27997,6815,1583,7177,0
460,2.5973,55,0,0,0,139.286,55,8189,0,0,231,0,6.4839,6815,1583,7177,0
509,2.87389,58,0,2,0,64.49,58,8189,2,0,207,2,5.86262,6817,1585,7179,0
601,3.39353,62,0,4,0,72.618,62,8189,4,0,190,4,6.58557,6821,1589,7183,0
623,3.51773,56,0,4,0,89.233,65,8189,4,0,233,4,7.76035,6825,1593,7187,0
583,3.29186,68,0,7,0,88.082,68,8189,7,0,176,7,6.58557,6832,1600,7194,0
610,3.44426,57,0,4,0,99.197,71,8189,4,0,215,4,4.58053,6836,1604,7198,0
602,3.3992,72,0,8,0,75.214,74,8189,8,0,190,8,4.8008,6844,1612,7206,0
465,2.62312,7,0,80,0,81.042,7,8189,63,0,164,4,3.94795,6907,1616,7286,0
450,2.54081,42,0,0,0,56,42,8189,0,0,213,0,4.89117,6907,1616,7286,0
509,2.87392,46,0,4,0,90.846,46,8187,4,0,193,4,5.51245,6911,1620,7290,0
536,3.02594,50,0,4,0,74.135,50,8190,4,0,202,4,5.89651,6915,1624,7294,0
553,3.12245,54,0,3,0,74.342,54,8191,3,0,182,3,5.17357,6918,1627,7297,0
579,3.2691,58,0,5,0,68.759,58,8189,5,0,212,5,4.72173,6923,1632,7302,0
506,2.85703,34,0,59,0,43.025,34,8191,59,0,212,1,5.72707,6982,1633,7361,0
521,2.94189,40,0,3,0,66.079,40,8191,3,0,230,3,4.5297,6985,1636,7364,0
536,3.02558,45,0,3,0,67.265,45,8189,3,0,191,3,4.11739,6988,1639,7367,0
516,2.91374,49,0,3,0,88.388,49,8189,3,0,216,3,3.41139,6991,1642,7370,0
487,2.74997,7,0,55,0,71.165,7,8191,55,0,171,3,4.26424,7046,1645,7425,0
482,2.71896,33,0,0,0,52.534,33,8189,0,0,237,0,5.9417,7046,1645,7425,0
540,3.04909,40,0,0,0,60.339,40,8191,0,0,273,0,4.69349,7046,1645,7425,0
542,3.06041,46,0,2,0,75.677,46,8191,2,0,234,2,4.86858,7048,1647,7427,0
556,3.13933,50,0,3,0,64.354,50,8191,3,0,234,3,7.02611,7051,1650,7430,0
598,3.37651,55,0,2,0,82.715,55,8189,2,0,250,2,6.69288,7053,1652,7432,0
559,3.15621,59,0,3,0,105.068,59,8189,3,0,231,3,5.94734,7056,1655,7435,0
431,2.43357,32,0,61,0,51.332,32,8189,61,0,154,1,6.32011,7117,1656,7496,0
530,2.99258,39,0,1,0,54.979,39,8189,1,0,249,1,5.53504,7118,1657,7497,0
469,2.64823,45,0,0,0,66.823,45,8189,0,0,237,0,4.60312,7118,1657,7497,0
559,3.15655,50,0,3,0,76.168,50,8188,3,0,239,3,4.84034,7121,1660,7500,0
588,3.32026,55,0,2,0,90.137,55,8187,2,0,253,2,5.03802,7123,1662,7502,0
478,2.69911,32,0,55,0,51.015,32,8189,55,0,204,0,4.5184,7178,1662,7557,0
478,2.69888,39,0,0,0,57.769,39,8189,0,0,239,0,5.10014,7178,1662,7557,0
564,3.18461,45,0,1,0,100.217,45,8189,1,0,267,1,5.62541,7179,1663,7558,0
453,2.55779,50,0,1,0,76.448,50,8189,1,0,228,1,6.61381,7180,1664,7559,0
421,2.37711,30,0,50,0,44.541,30,8189,50,0,176,0,9.4604,7230,1664,7609,0
486,2.74412,37,0,1,0,48.75,37,8191,1,0,227,1,7.37629,7231,1665,7610,0
553,3.12235,43,0,1,0,78.798,43,8189,1,0,261,1,4.37155,7232,1666,7611,0
596,3.36518,49,0,2,0,65.615,49,8189,2,0,278,2,4.78386,7234,1668,7613,0


