SendPacket,SendRate(Mb/s),FlightSize,ReceiveRate(Mb/s),Send Loss,Recv Loss,RTT(ms),CWnd,FlowWindow,Retrans,PktSndPeriod(us),RecvACK,RecvNAK,EstimatedBandwidth(Mb/s),Retrans_Total,NAK_TotalRecv,Total Send Loss,Total Recv Loss
277,3.03346,74,0,7,0,137.733,74,8157,7,0,72,7,10.5414,7,7,7,0
149,1.73498,28,0,77,0,80.403,28,8189,77,0,26,3,9.44653,84,10,84,0
250,2.91123,38,0,8,0,108.909,38,8190,8,0,73,8,7.22176,92,18,92,0
217,2.52691,40,0,7,0,125.08,40,8190,7,0,56,7,5.5095,99,25,99,0
218,2.53869,41,0,8,0,127.14,41,8191,8,0,55,8,4.19328,107,33,107,0
264,3.07424,43,0,7,0,132.322,43,8190,7,0,78,7,3.61088,114,40,114,0
235,2.73637,44,0,8,0,136.233,44,8191,8,0,58,8,3.13331,122,48,122,0
233,2.71321,45,0,9,0,137.076,45,8191,9,0,55,9,3.29638,131,57,131,0
179,2.08436,15,0,51,0,113.386,15,8189,51,0,33,5,3.48275,182,62,182,0
271,3.15572,27,0,4,0,86.144,27,8191,4,0,112,4,3.68077,186,66,186,0
223,2.59676,29,0,7,0,95.376,29,8190,7,0,73,7,3.96032,193,73,193,0
200,2.3284,18,0,31,0,61.46,18,8189,31,0,76,2,4.47283,224,75,224,0
221,2.57345,22,0,5,0,76.938,22,8176,5,0,87,5,4.20493,229,80,229,0
220,2.56159,15,0,24,0,49.168,15,8191,24,0,95,1,4.27482,253,81,253,0
234,2.72501,21,0,2,0,71.566,21,8191,2,0,112,2,4.32141,255,83,255,0
240,2.79492,15,0,23,0,50.404,15,8191,23,0,108,1,4.51942,278,84,278,0
186,2.16594,20,0,1,0,87.536,20,8191,1,0,87,1,4.26317,279,85,279,0
239,2.78088,24,0,3,0,85.624,24,8189,3,0,96,3,4.74074,282,88,282,0
211,2.45707,27,0,3,0,81.812,27,8189,3,0,72,3,4.30976,285,91,285,0
232,2.70157,30,0,6,0,91.599,30,8189,6,0,79,6,4.49613,291,97,291,0
186,2.16593,18,0,32,0,83.987,18,8191,32,0,74,2,4.00691,323,99,323,0
260,3.02727,23,0,3,0,76.955,23,8189,3,0,104,3,3.90208,326,102,326,0
203,2.36374,26,0,4,0,82.89,26,8190,4,0,75,4,3.02848,330,106,330,0
222,2.58505,17,0,29,0,62.754,17,8191,29,0,82,3,2.9353,359,109,359,0
196,2.28241,3,0,28,0,79.729,3,8189,28,0,71,3,2.90035,387,112,387,0
155,1.80517,13,0,0,0,52.663,13,8189,0,0,80,0,3.07507,387,112,387,0
243,2.82981,19,0,2,0,61.028,19,8189,2,0,110,2,2.50432,389,114,389,0
173,2.01466,14,0,21,0,61.984,14,8189,21,0,74,1,2.70234,410,115,410,0
211,2.45648,19,0,2,0,72.262,19,8191,2,0,93,2,2.76058,412,117,412,0
233,2.71319,25,0,0,0,99.355,25,8191,0,0,123,0,3.13331,412,117,412,0
234,2.7248,3,0,31,0,89.594,3,8191,31,0,84,3,3.21485,443,120,443,0
119,1.38521,11,0,3,0,39.842,11,8189,3,0,57,0,3.40122,446,120,446,0
226,2.63164,18,0,1,0,62.744,18,8173,1,0,110,1,3.62253,447,121,447,0
224,2.60835,22,0,3,0,80.843,22,8191,3,0,87,3,3.1799,450,124,450,0
250,2.90953,25,0,3,0,77.953,26,8191,3,0,105,3,3.04013,453,127,453,0
210,2.4454,15,0,29,0,60.968,16,8189,29,0,80,2,2.90035,482,129,482,0
197,2.29412,11,0,21,0,50.557,11,8191,21,0,87,1,3.15661,503,130,503,0
164,1.90974,8,0,17,0,64.45,8,8190,17,0,75,1,3.48275,520,131,520,0
200,2.32891,16,0,0,0,71.724,16,8189,0,0,104,0,3.65747,520,131,520,0
218,2.53853,11,0,21,0,48.467,11,8189,21,0,99,1,3.86714,541,132,541,0
210,2.44537,17,0,1,0,58.049,17,8191,1,0,99,1,4.32141,542,133,542,0
211,2.45693,4,0,25,0,72.426,4,8189,25,0,88,3,4.69414,567,136,567,0
118,1.37404,15,0,0,0,111.93,15,8189,0,0,59,0,5.16006,567,136,567,0
225,2.62013,21,0,0,0,82.743,21,8191,0,0,116,0,4.53107,567,136,567,0
221,2.5736,4,0,28,0,75.078,4,8189,28,0,79,4,4.40294,595,140,595,0
215,2.50357,18,0,0,0,71.37,18,8191,0,0,109,0,3.28474,595,140,595,0
181,2.10773,9,0,24,0,71.692,9,8189,24,0,64,3,3.4944,619,143,619,0
216,2.51542,18,0,0,0,63.511,18,8189,0,0,113,0,3.01683,619,143,619,0
235,2.73648,23,0,1,0,78.548,23,8191,1,0,124,1,3.06342,620,144,620,0
131,1.52561,6,0,37,0,51.732,6,8189,37,0,45,1,2.90035,657,145,657,0
116,1.35076,12,0,0,0,73.108,12,8189,0,0,60,0,2.90035,657,145,657,0
164,1.90997,18,0,0,0,79.73,18,8189,0,0,86,0,3.08672,657,145,657,0
141,1.64194,11,0,22,0,86.382,11,8189,22,0,52,2,3.05178,679,147,679,0
215,2.50362,18,0,1,0,61.554,18,8189,1,0,103,1,2.6441,680,148,680,0
168,1.95638,21,0,2,0,104.83,21,8191,2,0,69,2,2.5975,682,150,682,0
195,2.27064,4,0,27,0,85.713,4,8191,27,0,76,3,2.22477,709,153,709,0
199,2.31722,18,0,0,0,61.067,18,8189,0,0,98,0,2.41114,709,153,709,0
234,2.72492,23,0,3,0,77.897,23,8191,3,0,104,3,2.29466,712,156,712,0
232,2.70151,25,0,5,0,82.062,25,8191,5,0,69,5,2.43443,717,161,717,0
208,2.42213,28,0,4,0,117.268,28,8191,4,0,83,4,2.50432,721,165,721,0
221,2.57337,31,0,6,0,110.369,31,8189,6,0,86,6,2.3063,727,171,727,0
184,2.14255,33,0,5,0,109.9,33,8191,5,0,51,5,2.15488,732,176,732,0
252,2.9346,35,0,5,0,116.591,35,8191,5,0,65,5,2.37619,737,181,737,0
222,2.58512,36,0,5,0,124.344,36,8189,5,0,63,5,3.05178,742,186,742,0
215,2.50351,38,0,6,0,104.592,38,8189,6,0,39,6,3.06342,748,192,748,0
227,2.64326,39,0,7,0,130.916,39,8191,7,0,61,7,3.98362,755,199,755,0
270,3.14408,41,0,7,0,122.109,41,8189,7,0,83,7,4.50778,762,206,762,0
262,3.05089,43,0,8,0,111.157,43,8191,8,0,73,8,4.08845,770,214,770,0
237,2.75989,44,0,10,0,145.224,44,8191,10,0,61,10,3.75066,780,224,780,0
245,2.85302,46,0,9,0,152.647,46,8189,9,0,60,9,2.76058,789,233,789,0
154,1.7929,4,0,53,0,123.89,4,8189,53,0,31,4,2.51597,842,237,842,0
198,2.30567,14,0,0,0,61.077,14,8189,0,0,99,0,2.24806,842,237,842,0
223,2.59672,20,0,2,0,71.178,20,8172,2,0,98,2,2.11994,844,239,844,0
203,2.36376,24,0,2,0,84.121,24,8189,2,0,84,2,2.31795,846,241,846,0
179,2.08448,16,0,25,0,70.334,16,8189,25,0,76,1,2.57421,871,242,871,0
197,2.29421,11,0,20,0,55.246,11,8191,20,0,90,1,2.48102,891,243,891,0
172,2.00289,17,0,1,0,62.624,17,8189,1,0,84,1,2.58586,892,244,892,0
236,2.74826,22,0,3,0,74.97,22,8189,3,0,104,3,3.26144,895,247,895,0
192,2.23562,16,0,24,0,52.245,16,8189,24,0,85,2,3.11002,919,249,919,0
175,2.03771,8,0,21,0,76.039,9,8191,21,0,77,1,3.00518,940,250,940,0
171,1.99117,16,0,0,0,93.416,16,8189,0,0,91,0,2.99354,940,250,940,0
236,2.74814,22,0,0,0,76.934,22,8189,0,0,122,0,3.00518,940,250,940,0
232,2.70156,27,0,1,0,90.212,27,8189,1,0,107,1,2.90035,941,251,941,0
96,1.11792,7,0,42,0,106.204,7,8189,42,0,26,2,2.85376,983,253,983,0
67,0.780141,11,0,0,0,91.221,11,8189,0,0,37,0,2.69069,983,253,983,0
179,2.08443,17,0,0,0,72.484,17,8189,0,0,93,0,2.74893,983,253,983,0
240,2.79475,23,0,1,0,89.999,23,8189,1,0,112,1,2.98189,984,254,984,0
171,1.99124,3,0,27,0,98.599,3,8191,27,0,65,2,3.05178,1011,256,1011,0
163,1.89813,16,0,0,0,104.737,16,8191,0,0,81,0,3.58758,1011,256,1011,0
194,2.25898,21,0,3,0,67.614,21,8189,3,0,89,3,3.44781,1014,259,1014,0
173,2.0146,14,0,21,0,66.628,15,8189,21,0,75,0,3.34298,1035,259,1035,0
162,1.88641,9,0,19,0,61.864,9,8191,19,0,72,1,3.16826,1054,260,1054,0
194,2.25915,17,0,0,0,90.015,17,8191,0,0,99,0,3.00518,1054,260,1054,0
201,2.34075,22,0,1,0,84.557,22,8189,1,0,95,1,3.11002,1055,261,1055,0
154,1.7934,13,0,24,0,54.182,13,8189,24,0,62,1,3.27309,1079,262,1079,0
209,2.43293,19,0,0,0,109.42,19,8189,0,0,107,0,4.13504,1079,262,1079,0
256,2.98003,25,0,0,0,83.663,25,8189,0,0,134,0,5.22995,1079,262,1079,0
264,3.07414,30,0,1,0,109.176,30,8191,1,0,124,1,5.36973,1080,263,1080,0
237,2.75979,32,0,8,0,102.588,32,8189,8,0,78,8,4.93875,1088,271,1088,0
250,2.90944,35,0,5,0,107.339,35,8191,5,0,97,5,3.96032,1093,276,1093,0
174,2.02616,36,0,7,0,122.318,36,8187,7,0,39,7,3.36627,1100,283,1100,0
245,2.85282,38,0,5,0,117.189,38,8161,5,0,73,5,3.14496,1105,288,1105,0
235,2.73649,40,0,5,0,126.603,40,8189,5,0,80,5,2.78387,1110,293,1110,0
164,1.90972,21,0,41,0,67.849,21,8189,41,0,47,1,2.9353,1151,294,1151,0
242,2.81822,25,0,4,0,75.2,25,8189,4,0,87,4,3.14496,1155,298,1155,0
218,2.53872,28,0,4,0,103.48,28,8189,4,0,76,4,3.50605,1159,302,1159,0
182,2.11931,16,0,29,0,68.192,16,8191,29,0,77,1,3.56429,1188,303,1188,0
188,2.18916,21,0,1,0,88.52,21,8191,1,0,90,1,3.55264,1189,304,1189,0
229,2.66646,26,0,1,0,96.28,26,8191,1,0,110,1,3.45946,1190,305,1190,0
184,2.14268,4,0,34,0,94.881,4,8189,34,0,66,2,3.43616,1224,307,1224,0
108,1.25762,11,0,0,0,63.081,11,8189,0,0,55,0,3.31968,1224,307,1224,0
183,2.13114,17,0,0,0,67.137,17,8189,0,0,94,0,3.1799,1224,307,1224,0
200,2.32899,22,0,0,0,113.632,22,8189,0,0,104,0,2.71398,1224,307,1224,0
265,3.08623,27,0,3,0,86.071,27,8189,3,0,112,3,2.63245,1227,310,1227,0
200,2.3289,30,0,5,0,96.664,30,8191,5,0,78,5,2.6441,1232,315,1232,0
175,2.03779,18,0,31,0,68.458,18,8191,31,0,69,1,2.92365,1263,316,1263,0
141,1.6419,11,0,20,0,70.544,11,8191,20,0,59,1,2.81882,1283,317,1283,0
193,2.24762,18,0,0,0,81.142,18,8189,0,0,100,0,3.30803,1283,317,1283,0
237,2.7595,23,0,1,0,74.58,23,8191,1,0,113,1,3.50605,1284,318,1284,0
195,2.27072,12,0,28,0,84.615,12,8189,28,0,62,3,3.2032,1312,321,1312,0
180,2.09604,18,0,0,0,65.114,18,8191,0,0,91,0,2.63245,1312,321,1312,0
205,2.38731,22,0,1,0,106.529,22,8191,1,0,99,1,3.2032,1313,322,1313,0
240,2.79494,27,0,1,0,100.151,27,8190,1,0,116,1,2.3296,1314,323,1314,0
218,2.5388,30,0,4,0,112.971,30,8190,4,0,87,4,2.28301,1318,327,1318,0
250,2.91109,33,0,1,0,117.724,33,8190,1,0,101,1,2.49267,1319,328,1319,0
252,2.9344,36,0,1,0,131.762,36,8189,1,0,116,1,2.66739,1320,329,1320,0
263,3.06247,38,0,12,0,117.902,38,8189,12,0,73,12,3.01683,1332,341,1332,0
224,2.60829,40,0,6,0,125.449,40,8189,6,0,78,6,3.05178,1338,347,1338,0
231,2.68982,42,0,6,0,150.156,42,8190,6,0,61,6,3.56429,1344,353,1344,0
239,2.78324,43,0,7,0,132.728,43,8191,7,0,61,7,3.35462,1351,360,1351,0
220,2.56162,44,0,5,0,145.499,44,8189,5,0,50,5,3.21485,1356,365,1356,0
206,2.39898,45,0,7,0,150.852,45,8191,7,0,41,7,3.27309,1363,372,1363,0
249,2.89936,47,0,6,0,145.847,47,8189,6,0,63,6,3.4711,1369,378,1369,0
207,2.41052,48,0,8,0,147.539,48,8191,8,0,59,8,3.24979,1377,386,1377,0
167,1.94467,24,0,49,0,91.066,24,8189,49,0,47,1,3.48275,1426,387,1426,0
185,2.15441,13,0,29,0,70.063,13,8189,29,0,67,3,3.61088,1455,390,1455,0
200,2.32907,19,0,1,0,80.92,19,8191,1,0,97,1,3.92538,1456,391,1456,0
235,2.73673,24,0,3,0,99.634,24,8190,3,0,109,3,2.73728,1459,394,1459,0
234,2.72474,27,0,3,0,88.019,27,8191,3,0,86,3,2.99354,1462,397,1462,0
197,2.29413,30,0,5,0,97.688,30,8178,5,0,79,5,2.65574,1467,402,1467,0
222,2.58511,32,0,6,0,107.07,32,8189,6,0,63,6,2.87706,1473,408,1473,0
235,2.7367,35,0,1,0,135.756,35,8189,1,0,104,1,3.68077,1474,409,1474,0
252,2.93445,37,0,6,0,129.473,37,8156,6,0,77,6,3.99526,1480,415,1480,0
196,2.28235,3,0,42,0,129.116,3,8153,42,0,45,4,4.11174,1522,419,1522,0
192,2.23579,22,0,0,0,86.913,22,8189,0,0,93,0,3.96032,1522,419,1522,0
205,2.38716,26,0,5,0,108.455,26,8190,5,0,83,5,4.0768,1527,424,1527,0
266,3.09739,30,0,2,0,101.293,30,8191,2,0,113,2,3.79725,1529,426,1529,0
152,1.77008,15,0,34,0,57.411,15,8176,34,0,38,4,3.59923,1563,430,1563,0
224,2.60841,21,0,2,0,72.233,21,8191,2,0,98,2,3.34298,1565,432,1565,0
254,2.95775,25,0,3,0,73.471,25,8189,3,0,97,3,3.58758,1568,435,1568,0
202,2.3521,28,0,2,0,129.682,28,8191,2,0,79,2,3.70406,1570,437,1570,0
222,2.58512,31,0,4,0,107.11,31,8189,4,0,87,4,3.92538,1574,441,1574,0
218,2.53842,33,0,5,0,116.394,33,8191,5,0,66,5,4.51942,1579,446,1579,0
252,2.93416,36,0,1,0,124.423,36,8191,1,0,111,1,5.00864,1580,447,1580,0
221,2.57342,38,0,6,0,131.836,38,8190,6,0,60,6,5.2649,1586,453,1586,0
219,2.55024,39,0,8,0,119.868,39,8190,8,0,56,8,4.58931,1594,461,1594,0
230,2.67816,41,0,8,0,149.404,41,8190,8,0,61,8,4.82227,1602,469,1602,0
244,2.84106,42,0,5,0,129.04,42,8190,5,0,68,5,4.19328,1607,474,1607,0
194,2.25909,43,0,6,0,157.772,43,8190,6,0,37,6,3.61088,1613,480,1613,0
226,2.63155,44,0,7,0,146.582,44,8189,7,0,54,7,3.21485,1620,487,1620,0
220,2.56195,45,0,6,0,137.817,45,8146,6,0,46,6,3.29638,1626,493,1626,0
193,2.24741,46,0,8,0,148.876,46,8189,8,0,51,8,3.62253,1634,501,1634,0
200,2.32887,47,0,12,0,162.086,47,8177,12,0,41,12,3.44781,1646,513,1646,0
182,2.11927,24,0,48,0,80.289,24,8189,48,0,48,1,3.50605,1694,514,1694,0
236,2.74815,27,0,4,0,91.884,27,8189,4,0,84,4,3.70406,1698,518,1698,0
238,2.7714,30,0,4,0,123.046,30,8189,4,0,100,4,3.41286,1702,522,1702,0
215,2.50351,32,0,4,0,109.096,32,8189,4,0,65,4,3.45946,1706,526,1706,0
251,2.92278,34,0,8,0,98.325,34,8189,8,0,65,8,3.29638,1714,534,1714,0
228,2.65476,37,0,5,0,110.357,37,8189,5,0,83,5,3.2265,1719,539,1719,0
230,2.67829,39,0,7,0,129.07,39,8171,7,0,72,7,2.86541,1726,546,1726,0
240,2.79495,40,0,5,0,129.889,40,8151,5,0,58,5,2.98189,1731,551,1731,0
252,2.93463,42,0,6,0,132.813,42,8189,6,0,69,6,2.99354,1737,557,1737,0
224,2.6083,43,0,7,0,140.589,43,8191,7,0,52,7,2.97024,1744,564,1744,0
181,2.10784,44,0,6,0,151.667,44,8189,6,0,50,6,3.08672,1750,570,1750,0
260,3.02749,45,0,6,0,137.871,45,8160,6,0,55,6,2.9353,1756,576,1756,0
239,2.783,47,0,6,0,140.575,47,8189,6,0,73,6,2.63245,1762,582,1762,0
248,2.88806,48,0,9,0,165.225,48,8189,9,0,51,9,2.67904,1771,591,1771,0
100,1.16444,5,0,53,0,108.236,5,8189,53,0,26,2,2.73728,1824,593,1824,0
117,1.36241,12,0,0,0,68.172,12,8191,0,0,63,0,2.65574,1824,593,1824,0
166,1.933,18,0,0,0,57.654,18,8191,0,0,85,0,2.60915,1824,593,1824,0
233,2.71328,22,0,3,0,74.97,22,8170,3,0,91,3,3.11002,1827,596,1827,0
237,2.75978,26,0,4,0,81.488,26,8165,4,0,97,4,3.50605,1831,600,1831,0
223,2.59674,29,0,5,0,92.316,29,8191,5,0,89,5,2.99354,1836,605,1836,0
220,2.56146,31,0,6,0,108.333,31,8183,6,0,56,6,2.94694,1842,611,1842,0
204,2.37545,33,0,3,0,137.827,33,8189,3,0,76,3,2.97024,1845,614,1845,0
196,2.28234,17,0,38,0,63.114,17,8191,38,0,61,4,3.06342,1883,618,1883,0
199,2.31717,22,0,4,0,84.077,22,8191,4,0,85,4,2.66739,1887,622,1887,0
186,2.166,12,0,25,0,60.824,12,8190,25,0,60,2,2.66739,1912,624,1912,0
202,2.35221,18,0,1,0,64.324,18,8191,1,0,95,1,2.5975,1913,625,1913,0
230,2.67816,23,0,1,0,85.412,23,8189,1,0,111,1,2.60915,1914,626,1914,0
224,2.60831,27,0,3,0,85.416,27,8189,3,0,93,3,2.38784,1917,629,1917,0
225,2.61999,30,0,4,0,97.304,30,8191,4,0,88,4,2.76058,1921,633,1921,0
206,2.39871,32,0,4,0,121.14,32,8189,4,0,63,4,2.65574,1925,637,1925,0
278,3.23714,36,0,0,0,125.56,36,8191,0,0,145,0,3.21485,1925,637,1925,0
156,1.81653,8,0,43,0,133.182,8,8189,43,0,40,6,3.43616,1968,643,1968,0
207,2.41034,22,0,1,0,83.732,22,8189,1,0,100,1,3.69242,1969,644,1969,0
205,2.38713,17,0,22,0,64.869,17,8189,22,0,94,0,3.85549,1991,644,1991,0
192,2.23573,20,0,3,0,76.892,20,8172,3,0,74,3,4.25152,1994,647,1994,0
193,2.24743,25,0,1,0,114.911,25,8190,1,0,98,1,3.87878,1995,648,1995,0
205,2.38711,28,0,3,0,121.639,28,8190,3,0,82,3,4.00691,1998,651,1998,0
228,2.65517,30,0,5,0,104.979,30,8191,5,0,77,5,3.66912,2003,656,2003,0
236,2.74849,33,0,4,0,122.32,33,8189,4,0,91,4,3.55264,2007,660,2007,0
205,2.38703,35,0,7,0,109.367,35,8191,7,0,58,7,3.90208,2014,667,2014,0
229,2.66657,37,0,2,0,139.855,37,8189,2,0,87,2,4.03021,2016,669,2016,0
206,2.39882,39,0,6,0,142.568,39,8164,6,0,56,6,3.72736,2022,675,2022,0
261,3.03925,41,0,7,0,118.162,41,8189,7,0,89,7,3.59923,2029,682,2029,0
194,2.25905,42,0,6,0,124.494,42,8189,6,0,39,6,3.86714,2035,688,2035,0
234,2.72473,44,0,8,0,147.52,44,8191,8,0,76,8,3.85549,2043,696,2043,0
112,1.30416,7,0,47,0,56.152,7,8189,47,0,28,0,4.91546,2090,696,2090,0
205,2.3873,16,0,0,0,52.621,16,8189,0,0,106,0,4.55437,2090,696,2090,0
204,2.37567,6,0,22,0,68.686,6,8189,22,0,83,2,4.75238,2112,698,2112,0
189,2.20086,16,0,0,0,51.154,16,8190,0,0,98,0,4.84557,2112,698,2112,0
217,2.52694,21,0,2,0,68.371,21,8170,2,0,95,2,4.61261,2114,700,2114,0
223,2.59701,26,0,1,0,102.853,26,8189,1,0,103,1,3.8089,2115,701,2115,0
229,2.66669,28,0,6,0,94.151,28,8189,6,0,70,6,3.7856,2121,707,2121,0
205,2.38709,31,0,3,0,112.551,31,8189,3,0,83,3,3.93702,2124,710,2124,0
226,2.63171,33,0,8,0,102.954,33,8189,8,0,70,8,4.32141,2132,718,2132,0
247,2.87644,35,0,3,0,104.994,36,8190,3,0,98,3,3.8089,2135,721,2135,0
199,2.31738,37,0,5,0,155.702,37,8189,5,0,53,5,4.08845,2140,726,2140,0
237,2.75984,39,0,5,0,113.302,39,8189,5,0,68,5,4.67085,2145,731,2145,0
188,2.18918,6,0,44,0,138.555,6,8191,44,0,55,4,4.60096,2189,735,2189,0
206,2.39883,3,0,24,0,83.998,3,8168,24,0,87,1,4.40294,2213,736,2213,0
181,2.10769,17,0,0,0,59.928,17,8189,0,0,93,0,4.04186,2213,736,2213,0
229,2.66662,22,0,2,0,68.014,22,8189,2,0,100,2,4.23987,2215,738,2215,0
163,1.89805,15,0,23,0,53.42,15,8189,23,0,69,1,3.86714,2238,739,2238,0
211,2.45691,20,0,2,0,66.666,20,8189,2,0,101,2,3.62253,2240,741,2240,0
187,2.1775,15,0,20,0,53.317,15,8190,20,0,83,0,3.27309,2260,741,2260,0
192,2.23573,20,0,3,0,76.774,20,8189,3,0,83,3,3.09837,2263,744,2263,0
225,2.62009,24,0,3,0,98.167,24,8191,3,0,104,3,2.92365,2266,747,2266,0
236,2.74827,28,0,3,0,86.365,28,8164,3,0,86,3,2.86541,2269,750,2269,0
218,2.5386,31,0,5,0,93.324,31,8191,5,0,86,5,3.08672,2274,755,2274,0
227,2.64347,33,0,3,0,116.082,33,8189,3,0,89,3,3.33133,2277,758,2277,0
205,2.38714,35,0,4,0,124.211,35,8191,4,0,73,4,3.72736,2281,762,2281,0
199,2.31742,37,0,5,0,119.85,37,8189,5,0,51,5,4.0535,2286,767,2286,0
203,2.36369,38,0,6,0,126.909,38,8190,6,0,50,6,4.56602,2292,773,2292,0
205,2.38716,21,0,39,0,73.551,21,8189,39,0,70,1,4.32141,2331,774,2331,0
219,2.55011,25,0,2,0,98.64,25,8189,2,0,97,2,3.98362,2333,776,2333,0
189,2.20089,13,0,32,0,75.173,13,8191,32,0,54,5,4.08845,2365,781,2365,0
206,2.3988,19,0,0,0,66.234,19,8189,0,0,107,0,4.11174,2365,781,2365,0
199,2.31729,23,0,1,0,93.53,23,8189,1,0,94,1,4.27482,2366,782,2366,0
214,2.49211,27,0,5,0,84.41,27,8190,5,0,85,5,3.56429,2371,787,2371,0
247,2.87643,30,0,4,0,108.166,30,8190,4,0,92,4,3.94867,2375,791,2375,0
228,2.65505,32,0,6,0,105.897,32,8191,6,0,60,6,4.46118,2381,797,2381,0
225,2.62018,34,0,3,0,126.118,34,8157,3,0,87,3,3.55264,2384,800,2384,0
219,2.55024,37,0,3,0,136.937,37,8191,3,0,80,3,3.84384,2387,803,2387,0
224,2.60851,38,0,6,0,128.1,38,8190,6,0,61,6,4.22822,2393,809,2393,0
222,2.58512,40,0,4,0,151.853,40,8189,4,0,62,4,3.44781,2397,813,2397,0
248,2.88797,42,0,8,0,132.251,42,8189,8,0,69,8,3.57594,2405,821,2405,0
237,2.75972,43,0,4,0,124.657,43,8191,4,0,63,4,3.45946,2409,825,2409,0
221,2.57333,44,0,6,0,138.874,44,8190,6,0,51,6,3.52934,2415,831,2415,0
197,2.29393,45,0,6,0,161.411,45,8162,6,0,35,6,3.5177,2421,837,2421,0
233,2.71316,47,0,4,0,148.909,47,8189,4,0,99,4,3.45946,2425,841,2425,0
291,3.38752,49,0,11,0,140.721,49,8190,11,0,81,11,3.63418,2436,852,2436,0
264,3.07438,50,0,8,0,145.753,50,8189,8,0,65,8,3.68077,2444,860,2444,0
238,2.77118,51,0,6,0,173.648,51,8191,6,0,49,6,4.0768,2450,866,2450,0
249,2.89982,52,0,11,0,154.368,52,8191,11,0,39,11,4.69414,2461,877,2461,0
197,2.29393,53,0,11,0,166.13,53,8169,11,0,40,11,4.22822,2472,888,2472,0
294,3.42369,54,0,10,0,145.899,54,8190,10,0,85,10,4.00691,2482,898,2482,0
107,1.24603,11,0,57,0,135.911,11,8189,57,0,11,3,3.96032,2539,901,2539,0
244,2.84129,30,0,1,0,108.887,30,8189,1,0,104,1,3.84384,2540,902,2540,0
167,1.94463,16,0,33,0,61.978,16,8191,33,0,50,3,3.73901,2573,905,2573,0
95,1.10623,10,0,17,0,132.417,10,8191,17,0,43,0,3.93702,2590,905,2590,0
182,2.11947,17,0,0,0,61.217,17,8189,0,0,93,0,4.04186,2590,905,2590,0
161,1.87491,21,0,1,0,89.176,21,8189,1,0,76,1,3.40122,2591,906,2591,0
193,2.2475,25,0,0,0,95.385,25,8189,0,0,98,0,4.0768,2591,906,2591,0
211,2.45701,28,0,3,0,101.726,28,8191,3,0,98,3,3.72736,2594,909,2594,0
236,2.74811,31,0,6,0,89.57,31,8162,6,0,78,6,3.11002,2600,915,2600,0
212,2.46868,33,0,6,0,115.376,33,8191,6,0,64,6,2.98189,2606,921,2606,0
219,2.55013,35,0,4,0,131.181,35,8190,4,0,82,4,3.07507,2610,925,2610,0
220,2.56186,37,0,7,0,102.725,37,8190,7,0,47,7,2.69069,2617,932,2617,0
204,2.3754,38,0,5,0,126.692,38,8191,5,0,52,5,2.83046,2622,937,2622,0
173,2.01458,21,0,38,0,91.833,21,8189,38,0,63,0,3.45946,2660,937,2660,0
218,2.53869,26,0,0,0,98.157,26,8189,0,0,113,0,3.5177,2660,937,2660,0
177,2.06105,8,0,31,0,95.076,8,8189,31,0,52,4,3.73901,2691,941,2691,0
238,2.77136,19,0,1,0,56.673,19,8189,1,0,116,1,4.91546,2692,942,2692,0
193,2.24741,14,0,22,0,66.979,14,8189,22,0,86,1,3.89043,2714,943,2714,0
220,2.56181,20,0,2,0,63.064,20,8190,2,0,106,2,3.92538,2716,945,2716,0
193,2.24741,13,0,23,0,61.421,13,8189,23,0,76,1,3.65747,2739,946,2739,0
213,2.48032,19,0,2,0,58.569,19,8189,2,0,97,2,2.90035,2741,948,2741,0
249,2.89955,24,0,1,0,74.881,24,8191,1,0,120,1,2.58586,2742,949,2742,0
219,2.55013,15,0,29,0,50.624,15,8189,29,0,84,3,2.9353,2771,952,2771,0
200,2.32907,20,0,0,0,75.135,20,8189,0,0,106,0,2.97024,2771,952,2771,0
206,2.39882,25,0,1,0,117.945,25,8189,1,0,98,1,3.21485,2772,953,2772,0
224,2.60849,28,0,5,0,85.32,28,8190,5,0,92,5,3.72736,2777,958,2777,0
207,2.41047,18,0,31,0,56.933,18,8189,31,0,81,3,3.77395,2808,961,2808,0
234,2.72464,23,0,1,0,82.038,23,8189,1,0,116,1,4.0768,2809,962,2809,0
189,2.20097,16,0,26,0,54.037,16,8189,26,0,81,2,3.41286,2835,964,2835,0
211,2.45711,21,0,0,0,111.563,21,8191,0,0,111,0,3.96032,2835,964,2835,0
205,2.3873,26,0,0,0,110.889,26,8189,0,0,109,0,3.13331,2835,964,2835,0
236,2.74829,30,0,2,0,106.828,30,8189,2,0,110,2,3.30803,2837,966,2837,0
237,2.75976,32,0,5,0,95.98,32,8189,5,0,79,5,3.15661,2842,971,2842,0
246,2.86452,35,0,5,0,115.631,35,8189,5,0,80,5,3.93702,2847,976,2847,0
203,2.36368,36,0,6,0,130.255,36,8191,6,0,55,6,3.97197,2853,982,2853,0
245,2.85285,38,0,4,0,133.006,38,8189,4,0,74,4,4.01856,2857,986,2857,0
216,2.51516,40,0,6,0,129.184,40,8191,6,0,54,6,4.368,2863,992,2863,0
236,2.74814,41,0,7,0,126.199,41,8189,7,0,63,7,4.28646,2870,999,2870,0
243,2.82967,44,0,4,0,148.479,44,8190,4,0,108,4,3.15661,2874,1003,2874,0
280,3.26039,45,0,10,0,110.521,45,8191,10,0,48,10,3.38957,2884,1013,2884,0
200,2.32884,21,0,49,0,97.308,21,8191,49,0,48,4,4.75238,2933,1017,2933,0
236,2.74835,26,0,2,0,98.687,26,8191,2,0,100,2,4.82227,2935,1019,2935,0
233,2.71327,29,0,2,0,118.145,29,8191,2,0,106,2,4.6825,2937,1021,2937,0
203,2.36394,31,0,4,0,104.419,31,8189,4,0,63,4,5.2649,2941,1025,2941,0
241,2.80635,34,0,4,0,109.791,34,8190,4,0,98,4,4.43789,2945,1029,2945,0
243,2.82963,36,0,6,0,98.514,36,8189,6,0,76,6,3.62253,2951,1035,2951,0
184,2.14261,38,0,6,0,132.366,38,8161,6,0,45,6,3.70406,2957,1041,2957,0
259,3.01589,40,0,5,0,105.768,40,8189,5,0,75,5,4.0768,2962,1046,2962,0
201,2.3406,41,0,8,0,141.142,41,8191,8,0,62,8,4.43789,2970,1054,2970,0
201,2.34058,22,0,42,0,77.194,22,8191,42,0,62,1,3.90208,3012,1055,3012,0
178,2.07274,25,0,3,0,73.735,25,8189,3,0,69,3,3.8089,3015,1058,3015,0
199,2.3172,28,0,1,0,88.776,28,8189,1,0,90,1,4.16998,3016,1059,3016,0
255,2.96937,31,0,4,0,99.163,31,8189,4,0,101,4,4.14669,3020,1063,3020,0
206,2.39882,34,0,6,0,117.648,34,8189,6,0,74,6,4.57766,3026,1069,3026,0
245,2.85287,36,0,2,0,138.865,36,8191,2,0,97,2,4.70579,3028,1071,3028,0
216,2.51539,38,0,4,0,118.925,38,8189,4,0,75,4,5.59104,3032,1075,3032,0
231,2.69008,40,0,7,0,127.529,40,8189,7,0,64,7,5.18336,3039,1082,3039,0
220,2.5618,42,0,8,0,116.5,42,8191,8,0,73,8,5.00864,3047,1090,3047,0
226,2.63172,43,0,7,0,123.09,43,8189,7,0,55,7,4.49613,3054,1097,3054,0
196,2.28235,22,0,44,0,80.593,22,8169,44,0,62,1,4.03021,3098,1098,3098,0
241,2.80637,27,0,1,0,97.627,27,8191,1,0,113,1,3.72736,3099,1099,3099,0
274,3.19063,31,0,2,0,98.941,31,8191,2,0,129,2,3.37792,3101,1101,3101,0
212,2.46871,34,0,2,0,138.279,34,8191,2,0,97,2,3.16826,3103,1103,3103,0
240,2.7948,36,0,5,0,116.599,36,8191,5,0,58,5,3.19155,3108,1108,3108,0
230,2.67822,38,0,6,0,119.82,38,8190,6,0,84,6,2.84211,3114,1114,3114,0
224,2.60836,40,0,11,0,123.263,40,8189,11,0,60,11,3.87878,3125,1125,3125,0
229,2.6666,41,0,8,0,129.84,41,8190,8,0,59,8,3.73901,3133,1133,3133,0
229,2.66662,42,0,9,0,148.576,42,8189,9,0,59,9,3.71571,3142,1142,3142,0
224,2.6084,44,0,7,0,135.898,44,8189,7,0,52,7,4.91546,3149,1149,3149,0
260,3.02759,45,0,5,0,130.241,45,8190,5,0,71,5,4.67085,3154,1154,3154,0
247,2.87637,47,0,9,0,144.225,47,8189,9,0,61,9,3.59923,3163,1163,3163,0
241,2.80642,48,0,7,0,151.664,48,8189,7,0,55,7,3.58758,3170,1170,3170,0
234,2.72486,49,0,9,0,152.385,49,8191,9,0,60,9,3.63418,3179,1179,3179,0
163,1.89807,24,0,50,0,71.775,24,8191,50,0,39,1,3.77395,3229,1180,3229,0
210,2.44539,28,0,2,0,112.067,28,8171,2,0,87,2,3.91373,3231,1182,3231,0
230,2.67822,31,0,2,0,92.805,31,8191,2,0,92,2,4.16998,3233,1184,3233,0
262,3.05088,33,0,7,0,110.3,33,8191,7,0,81,7,4.08845,3240,1191,3240,0
231,2.69014,35,0,5,0,101.618,35,8189,5,0,73,5,3.36627,3245,1196,3245,0
192,2.23582,37,0,8,0,97.324,37,8190,8,0,47,8,3.23814,3253,1204,3253,0
240,2.79472,38,0,7,0,138.652,38,8177,7,0,58,7,3.04013,3260,1211,3260,0
234,2.72484,4,0,43,0,124.934,4,8190,43,0,57,4,2.94694,3303,1215,3303,0
167,1.9447,21,0,1,0,61.938,21,8189,1,0,70,1,2.97024,3304,1216,3304,0
273,3.179,27,0,2,0,79.482,27,8191,2,0,130,1,3.16826,3306,1217,3306,0
242,2.81789,30,0,3,0,117.28,30,8189,3,0,99,3,3.48275,3309,1220,3309,0
261,3.03941,34,0,1,0,96.117,34,8191,1,0,134,1,4.23987,3310,1221,3310,0
237,2.75998,36,0,6,0,107.522,36,8191,6,0,57,6,4.56602,3316,1227,3316,0
233,2.71323,38,0,7,0,122.892,38,8191,7,0,83,7,4.67085,3323,1234,3323,0
252,2.93457,40,0,5,0,109.848,40,8189,5,0,77,5,5.2416,3328,1239,3328,0
221,2.5734,42,0,8,0,123.581,42,8191,8,0,75,8,4.18163,3336,1247,3336,0
180,2.09595,18,0,45,0,95.059,18,8189,45,0,36,3,4.3913,3381,1250,3381,0
152,1.77,8,0,26,0,44.634,8,8189,26,0,63,1,3.65747,3407,1251,3407,0
185,2.15429,16,0,0,0,59.483,16,8189,0,0,99,0,3.69242,3407,1251,3407,0
215,2.50359,22,0,0,0,83.425,22,8189,0,0,109,0,3.93702,3407,1251,3407,0
238,2.77138,25,0,4,0,85.212,25,8189,4,0,92,4,4.06515,3411,1255,3411,0
239,2.78294,29,0,2,0,93.854,29,8189,2,0,98,2,3.54099,3413,1257,3413,0
230,2.67819,31,0,3,0,102.847,31,8191,3,0,76,3,4.21658,3416,1260,3416,0
230,2.67823,35,0,3,0,143.397,35,8191,3,0,102,3,4.27482,3419,1263,3419,0
239,2.78308,37,0,2,0,131.346,37,8191,2,0,72,2,4.19328,3421,1265,3421,0
238,2.77171,39,0,4,0,131.044,39,8191,4,0,86,4,3.77395,3425,1269,3425,0
224,2.60858,40,0,7,0,129.624,40,8190,7,0,55,7,3.68077,3432,1276,3432,0
231,2.68993,42,0,6,0,154.039,42,8191,6,0,68,6,4.368,3438,1282,3438,0
227,2.64335,43,0,12,0,144.703,43,8189,12,0,54,12,4.57766,3450,1294,3450,0
231,2.68981,45,0,5,0,168.972,45,8189,5,0,78,5,4.12339,3455,1299,3455,0
179,2.08433,4,0,50,0,127.107,4,8191,50,0,31,5,4.25152,3505,1304,3505,0
155,1.80494,12,0,23,0,62.201,12,8190,23,0,59,1,4.54272,3528,1305,3528,0
228,2.65502,19,0,1,0,64.745,19,8189,1,0,110,1,4.74074,3529,1306,3529,0
222,2.58514,24,0,2,0,86.168,24,8189,2,0,103,2,4.19328,3531,1308,3531,0
151,1.75834,3,0,32,0,85.337,3,8191,10,0,63,1,4.60096,3541,1309,3563,0
68,0.791802,9,0,0,0,92.074,9,8189,0,0,35,0,4.47283,3541,1309,3563,0
216,2.51519,17,0,2,0,60.278,17,8191,2,0,106,2,4.04186,3543,1311,3565,0
223,2.59677,3,0,23,0,77.222,3,8191,23,0,94,1,3.8089,3566,1312,3588,0
105,1.22274,10,0,3,0,53.125,10,8189,3,0,55,0,3.41286,3569,1312,3591,0
172,2.00308,17,0,0,0,70.809,17,8189,0,0,89,0,3.21485,3569,1312,3591,0
215,2.50372,21,0,1,0,79.833,22,8189,1,0,104,1,2.66739,3570,1313,3592,0
237,2.75976,25,0,7,0,72.23,25,8191,7,0,84,7,2.73728,3577,1320,3599,0
217,2.52702,29,0,5,0,92.96,29,8190,5,0,87,5,2.77222,3582,1325,3604,0
233,2.71296,31,0,5,0,87.89,31,8190,5,0,79,5,3.41286,3587,1330,3609,0
204,2.37553,13,0,35,0,106.629,13,8189,35,0,54,2,3.98362,3622,1332,3644,0
200,2.32891,21,0,0,0,101.382,21,8189,0,0,104,0,5.04358,3622,1332,3644,0
233,2.71304,25,0,5,0,77.56,25,8189,5,0,88,5,4.3447,3627,1337,3649,0
181,2.1077,13,0,29,0,77.386,13,8189,29,0,63,2,4.47283,3656,1339,3678,0
206,2.39866,19,0,0,0,73.762,19,8191,0,0,106,0,3.2032,3656,1339,3678,0
230,2.67827,23,0,3,0,73.36,23,8189,3,0,90,3,2.86541,3659,1342,3681,0
210,2.44536,27,0,2,0,85.633,27,8189,2,0,86,2,2.83046,3661,1344,3683,0
192,2.23545,16,0,28,0,46.523,16,8189,28,0,82,1,3.08672,3689,1345,3711,0
158,1.83992,20,0,0,0,76.396,20,8189,0,0,82,0,3.24979,3689,1345,3711,0
249,2.89968,26,0,1,0,89.801,26,8189,1,0,121,1,3.7856,3690,1346,3712,0
234,2.72495,29,0,1,0,108.744,29,8162,1,0,109,1,4.27482,3691,1347,3713,0
216,2.51538,32,0,3,0,113.237,32,8191,3,0,94,3,3.89043,3694,1350,3716,0
205,2.38734,16,0,36,0,66.166,16,8191,36,0,52,3,3.69242,3730,1353,3752,0
227,2.64319,21,0,2,0,65.849,21,8191,2,0,101,2,3.56429,3732,1355,3754,0
179,2.08443,9,0,27,0,86.837,9,8189,27,0,66,3,3.84384,3759,1358,3781,0
144,1.67676,16,0,1,0,74.255,16,8189,1,0,69,1,3.54099,3760,1359,3782,0
200,2.32891,6,0,22,0,73.9,6,8189,22,0,83,2,3.71571,3782,1361,3804,0
183,2.13098,13,0,6,0,49.209,13,8189,6,0,93,0,4.28646,3788,1361,3810,0
242,2.81809,21,0,0,0,73.549,21,8191,0,0,124,0,3.86714,3788,1361,3810,0
235,2.73649,25,0,4,0,70.317,25,8190,4,0,100,4,3.54099,3792,1365,3814,0
211,2.45702,28,0,4,0,93.965,28,8189,4,0,72,4,3.50605,3796,1369,3818,0
221,2.57356,18,0,30,0,54.367,18,8190,30,0,93,2,2.73728,3826,1371,3848,0
235,2.73631,23,0,1,0,77.591,23,8189,1,0,115,1,2.9353,3827,1372,3849,0
250,2.91125,27,0,3,0,87.625,27,8189,3,0,105,3,3.05178,3830,1375,3852,0
222,2.5853,30,0,4,0,97.465,30,8189,4,0,75,4,3.72736,3834,1379,3856,0
266,3.09758,5,0,38,0,99.255,3,8191,38,0,92,5,4.79898,3872,1384,3894,0
200,2.32891,20,0,1,0,70.508,20,8189,1,0,87,1,4.74074,3873,1385,3895,0
187,2.17737,24,0,1,0,133.108,24,8189,1,0,89,1,4.3913,3874,1386,3896,0
212,2.46874,3,0,31,0,82.555,3,8165,31,0,67,5,4.08845,3905,1391,3927,0
210,2.44548,18,0,0,0,82.389,18,8189,0,0,104,0,3.83219,3905,1391,3927,0
218,2.53864,22,0,4,0,76.939,22,8189,4,0,85,4,3.82054,3909,1395,3931,0
229,2.66659,26,0,2,0,85.882,26,8189,2,0,96,2,3.45946,3911,1397,3933,0
246,2.86459,29,0,3,0,86.318,29,8189,3,0,89,3,3.54099,3914,1400,3936,0
221,2.57349,32,0,5,0,93.647,32,8191,5,0,82,5,3.11002,3919,1405,3941,0
258,3.00442,19,0,35,0,61.439,19,8189,35,0,94,2,2.83046,3954,1407,3976,0
218,2.53847,23,0,2,0,93.682,23,8191,2,0,96,2,3.05178,3956,1409,3978,0
228,2.65498,27,0,4,0,73.92,27,8191,4,0,82,4,3.58758,3960,1413,3982,0
234,2.72461,14,0,32,0,71.703,14,8191,32,0,89,3,3.05178,3992,1416,4014,0
148,1.72364,11,0,16,0,40.106,11,8189,16,0,67,1,3.12166,4008,1417,4030,0
246,2.86455,19,0,1,0,63.659,19,8191,1,0,118,1,3.35462,4009,1418,4031,0
171,1.99122,13,0,20,0,61.554,13,8189,20,0,74,1,3.01683,4029,1419,4051,0
197,2.29385,19,0,1,0,91.11,19,8189,1,0,96,1,3.14496,4030,1420,4052,0
231,2.6899,24,0,1,0,101.115,24,8191,1,0,112,1,3.19155,4031,1421,4053,0
227,2.64347,14,0,28,0,49.276,14,8189,28,0,90,2,3.05178,4059,1423,4081,0
244,2.84119,21,0,2,0,73.51,21,8184,2,0,114,2,3.40122,4061,1425,4083,0
228,2.65496,24,0,5,0,73.93,24,8191,5,0,77,5,3.2265,4066,1430,4088,0
188,2.18917,15,0,26,0,66.037,15,8191,26,0,82,1,3.09837,4092,1431,4114,0
216,2.51531,20,0,2,0,71.202,20,8189,2,0,93,2,3.14496,4094,1433,4116,0
220,2.5619,16,0,22,0,50.452,16,8189,22,0,103,1,3.48275,4116,1434,4138,0
191,2.22412,21,0,1,0,90.886,21,8191,1,0,89,1,3.44781,4117,1435,4139,0
253,2.94617,26,0,1,0,89.955,26,8189,1,0,118,1,4.53107,4118,1436,4140,0
240,2.79451,29,0,6,0,83.114,29,8191,6,0,86,6,4.49613,4124,1442,4146,0
238,2.77136,32,0,6,0,100.984,32,8189,6,0,79,6,4.3913,4130,1448,4152,0
239,2.78303,34,0,5,0,111.755,34,8189,5,0,64,5,4.90381,4135,1453,4157,0
230,2.67829,36,0,4,0,161.26,36,8189,4,0,86,4,4.16998,4139,1457,4161,0
234,2.72484,38,0,8,0,124.803,38,8190,8,0,68,8,3.7623,4147,1465,4169,0
211,2.45699,39,0,7,0,129.301,39,8184,7,0,52,7,3.68077,4154,1472,4176,0
213,2.48031,40,0,8,0,121.499,40,8169,8,0,39,8,3.37792,4162,1480,4184,0
255,2.96938,42,0,6,0,130.943,42,8189,6,0,63,6,2.94694,4168,1486,4190,0
214,2.4919,44,0,4,0,128.468,44,8191,4,0,89,4,3.2265,4172,1490,4194,0
234,2.72483,45,0,4,0,132.929,45,8189,4,0,56,4,3.23814,4176,1494,4198,0
243,2.8296,46,0,9,0,122,46,8189,9,0,57,9,3.27309,4185,1503,4207,0
192,2.23575,24,0,47,0,91.167,24,8189,47,0,56,1,3.5177,4232,1504,4254,0
195,2.27061,15,0,26,0,50.176,15,8190,26,0,83,1,3.69242,4258,1505,4280,0
234,2.72485,21,0,2,0,78.653,21,8191,2,0,104,2,3.24979,4260,1507,4282,0
216,2.51544,25,0,1,0,103.228,25,8189,1,0,101,1,3.70406,4261,1508,4283,0
250,2.91133,28,0,4,0,102.227,29,8190,3,0,105,4,3.64582,4264,1512,4287,0
215,2.50358,31,0,4,0,107.055,31,8167,5,0,56,4,3.34298,4269,1516,4291,0
258,3.00436,34,0,1,0,120.164,34,8191,1,0,112,1,3.54099,4270,1517,4292,0
225,2.61998,37,0,2,0,124.514,37,8190,2,0,98,2,4.6592,4272,1519,4294,0
262,3.05076,39,0,3,0,114.225,39,8191,3,0,79,3,4.96205,4275,1522,4297,0
221,2.57342,40,0,5,0,143.772,40,8189,5,0,56,5,5.13677,4280,1527,4302,0
251,2.92282,42,0,5,0,115.971,42,8189,5,0,71,5,4.60096,4285,1532,4307,0
219,2.55027,43,0,9,0,157.754,43,8189,9,0,51,9,4.98534,4294,1541,4316,0
240,2.79477,45,0,8,0,117.347,45,8157,8,0,63,8,4.81062,4302,1549,4324,0
191,2.22401,22,0,46,0,69.789,22,8189,46,0,60,1,4.62426,4348,1550,4370,0
239,2.78321,27,0,2,0,103.668,27,8191,2,0,113,2,3.31968,4350,1552,4372,0
239,2.78309,30,0,3,0,108.023,30,8190,3,0,97,3,3.38957,4353,1555,4375,0
172,2.00284,15,0,32,0,71.468,15,8189,32,0,55,1,3.45946,4385,1556,4407,0
247,2.87621,21,0,3,0,66.763,21,8189,3,0,116,3,3.33133,4388,1559,4410,0
230,2.67848,25,0,4,0,63.01,25,8189,4,0,77,4,2.98189,4392,1563,4414,0
271,3.15554,30,0,0,0,89.612,30,8189,0,0,138,0,3.06342,4392,1563,4414,0
175,2.03776,16,0,32,0,71.729,16,8189,32,0,68,1,3.28474,4424,1564,4446,0
164,1.90975,12,0,18,0,59.072,12,8189,18,0,71,1,3.16826,4442,1565,4464,0
244,2.84131,19,0,1,0,54.939,19,8189,1,0,118,1,3.27309,4443,1566,4465,0
213,2.48025,23,0,3,0,70.802,23,8189,3,0,84,3,3.72736,4446,1569,4468,0
183,2.13094,5,0,30,0,73.132,5,8189,30,0,67,2,3.4944,4476,1571,4498,0
113,1.31583,12,0,0,0,70.512,12,8191,0,0,58,0,3.65747,4476,1571,4498,0
198,2.30561,18,0,0,0,73.023,18,8191,0,0,104,0,3.70406,4476,1571,4498,0
219,2.55014,22,0,3,0,78.443,22,8191,3,0,81,3,3.7623,4479,1574,4501,0
221,2.57335,26,0,3,0,93.488,26,8189,3,0,91,3,3.27309,4482,1577,4504,0
94,1.09456,13,0,28,0,106.721,13,8189,28,0,30,2,3.21485,4510,1579,4532,0
104,1.2111,17,0,0,0,130.17,17,8190,0,0,53,0,3.35462,4510,1579,4532,0
187,2.17754,22,0,0,0,104.238,22,8191,0,0,98,0,2.97024,4510,1579,4532,0
226,2.63163,26,0,1,0,101.791,26,8191,1,0,107,1,2.99354,4511,1580,4533,0
250,2.91114,29,0,5,0,106.403,29,8189,5,0,95,5,3.58758,4516,1585,4538,0
239,2.78305,32,0,4,0,111.666,32,8191,4,0,94,4,4.08845,4520,1589,4542,0
209,2.43371,35,0,3,0,116.499,35,8189,3,0,78,3,3.66912,4523,1592,4545,0
285,3.31869,38,0,7,0,114.174,38,8190,7,0,111,7,4.22822,4530,1599,4552,0
255,2.96921,40,0,6,0,119.941,40,8190,6,0,94,6,4.41459,4536,1605,4558,0
254,2.95768,42,0,8,0,139.021,42,8191,8,0,63,8,4.96205,4544,1613,4566,0
223,2.59672,43,0,4,0,141.237,43,8189,4,0,64,4,4.6592,4548,1617,4570,0
248,2.88792,44,0,10,0,121.312,44,8173,10,0,42,10,4.60096,4558,1627,4580,0
268,3.12071,46,0,9,0,126.268,46,8191,9,0,98,9,4.78733,4567,1636,4589,0
206,2.39892,47,0,8,0,140.224,47,8189,8,0,32,8,4.35635,4575,1644,4597,0
188,2.18929,7,0,51,0,155.873,7,8191,51,0,47,3,4.3447,4626,1647,4648,0
210,2.44559,26,0,3,0,79.806,26,8190,3,0,77,3,4.6359,4629,1650,4651,0
241,2.80651,29,0,4,0,85.959,29,8191,4,0,87,4,3.89043,4633,1654,4655,0
275,3.20222,32,0,4,0,88.54,32,8191,4,0,85,4,3.61088,4637,1658,4659,0
181,2.10757,18,0,34,0,61.382,18,8189,34,0,61,2,4.47283,4671,1660,4693,0
229,2.66657,23,0,0,0,79.483,23,8189,0,0,117,0,3.8089,4671,1660,4693,0
198,2.30553,27,0,1,0,114.056,27,8189,1,0,91,1,3.73901,4672,1661,4694,0
230,2.67825,30,0,3,0,110.568,30,8190,3,0,107,3,4.33306,4675,1664,4697,0
219,2.55015,33,0,1,0,155.444,33,8189,1,0,85,1,4.61261,4676,1665,4698,0
219,2.55014,35,0,5,0,132.08,35,8191,5,0,80,5,3.92538,4681,1670,4703,0
216,2.51521,37,0,7,0,118.809,37,8191,7,0,68,7,4.33306,4688,1677,4710,0
274,3.1906,39,0,7,0,126.235,39,8189,7,0,69,7,3.58758,4695,1684,4717,0
234,2.72473,40,0,8,0,119.179,40,8191,8,0,51,8,3.01683,4703,1692,4725,0
250,2.91126,42,0,8,0,125.829,42,8191,8,0,80,8,2.912,4711,1700,4733,0
236,2.74813,43,0,7,0,143.527,43,8186,7,0,49,7,3.00518,4718,1707,4740,0
252,2.9346,45,0,5,0,147.422,45,8189,5,0,65,5,3.21485,4723,1712,4745,0
177,2.06118,23,0,47,0,80.847,23,8189,47,0,61,2,3.21485,4770,1714,4792,0
165,1.92138,14,0,26,0,70.285,14,8189,26,0,68,2,3.57594,4796,1716,4818,0
185,2.15399,19,0,1,0,71.248,19,8189,1,0,89,1,3.23814,4797,1717,4819,0
235,2.7364,24,0,2,0,91.351,24,8191,2,0,100,2,3.36627,4799,1719,4821,0
227,2.6433,27,0,3,0,107.652,27,8191,3,0,93,3,3.30803,4802,1722,4824,0
214,2.49194,30,0,4,0,112.474,30,8190,4,0,86,4,3.75066,4806,1726,4828,0
236,2.74828,33,0,7,0,104.829,33,8191,7,0,92,7,3.84384,4813,1733,4835,0
238,2.77139,35,0,4,0,118.701,35,8191,4,0,72,4,4.1001,4817,1737,4839,0
214,2.49199,37,0,5,0,128.337,37,8190,5,0,57,5,4.26317,4822,1742,4844,0
246,2.86469,39,0,2,0,149.108,39,8189,2,0,92,2,4.46118,4824,1744,4846,0
232,2.70154,41,0,7,0,136.947,41,8169,7,0,61,7,5.02029,4831,1751,4853,0
211,2.45708,42,0,6,0,135.403,42,8168,6,0,56,6,4.32141,4837,1757,4859,0
300,3.49357,45,0,5,0,136.299,45,8189,5,0,126,5,4.50778,4842,1762,4864,0
225,2.62022,46,0,9,0,133.025,46,8164,9,0,56,9,4.6592,4851,1771,4873,0
196,2.28243,25,0,46,0,100.533,25,8191,46,0,70,0,3.61088,4897,1771,4919,0
187,2.17766,14,0,29,0,60.348,14,8189,29,0,68,3,3.93702,4926,1774,4948,0
230,2.67819,21,0,1,0,68.54,21,8189,1,0,112,1,4.14669,4927,1775,4949,0
166,1.93305,3,0,29,0,82.705,3,8189,29,0,64,2,4.16998,4956,1777,4978,0
153,1.78162,12,0,0,0,57.133,12,8191,0,0,77,0,4.35635,4956,1777,4978,0
168,1.95627,18,0,1,0,76.892,18,8189,1,0,79,1,4.55437,4957,1778,4979,0
139,1.61853,12,0,20,0,62.516,12,8191,20,0,62,1,4.82227,4977,1779,4999,0
197,2.29385,18,0,1,0,63.613,18,8189,1,0,97,1,5.09018,4978,1780,5000,0
242,2.818,24,0,1,0,76.261,24,8189,1,0,119,1,3.1799,4979,1781,5001,0
148,1.72345,12,0,27,0,91.579,12,8191,27,0,50,2,2.57421,5006,1783,5028,0
168,1.95629,18,0,1,0,76.79,18,8189,1,0,89,1,2.44608,5007,1784,5029,0
182,2.11931,15,0,18,0,56.697,15,8191,18,0,85,0,2.49267,5025,1784,5047,0
227,2.64313,21,0,0,0,87.559,21,8189,0,0,116,0,2.78387,5025,1784,5047,0
207,2.41063,25,0,2,0,97.719,25,8189,2,0,85,2,3.1799,5027,1786,5049,0
173,2.01465,8,0,29,0,83.984,8,8189,29,0,61,2,4.14669,5056,1788,5078,0
174,2.0263,18,0,0,0,82.166,18,8189,0,0,86,0,4.14669,5056,1788,5078,0
222,2.58508,22,0,3,0,78.674,22,8189,3,0,96,3,4.1001,5059,1791,5081,0
210,2.44538,26,0,3,0,108.187,26,8190,3,0,87,3,3.63418,5062,1794,5084,0
190,2.21253,14,0,30,0,67.85,14,8189,30,0,56,3,3.06342,5092,1797,5114,0
208,2.42214,20,0,1,0,73.142,20,8189,1,0,99,1,3.01683,5093,1798,5115,0
250,2.91132,25,0,2,0,88.386,25,8189,2,0,111,2,2.56256,5095,1800,5117,0
240,2.7947,28,0,2,0,89.427,28,8189,2,0,100,2,2.6208,5097,1802,5119,0
190,2.21265,16,0,32,0,56.335,16,8191,32,0,67,2,3.12166,5129,1804,5151,0
244,2.84114,22,0,2,0,77.567,22,8189,2,0,118,2,3.2265,5131,1806,5153,0
239,2.783,26,0,1,0,89.558,26,8165,1,0,111,1,4.3447,5132,1807,5154,0
171,1.99126,14,0,30,0,81.954,14,8189,30,0,57,2,4.90381,5162,1809,5184,0
167,1.94482,19,0,1,0,95.323,19,8191,1,0,79,1,4.71744,5163,1810,5185,0
176,2.04956,12,0,22,0,52.888,12,8189,22,0,70,2,3.69242,5185,1812,5207,0
144,1.67681,17,0,0,0,89.743,17,8189,0,0,75,0,3.23814,5185,1812,5207,0
237,2.75991,23,0,0,0,78.855,23,8191,0,0,122,0,2.92365,5185,1812,5207,0
202,2.35225,5,0,28,0,86.006,5,8189,28,0,79,2,3.27309,5213,1814,5235,0
197,2.29398,18,0,2,0,68.057,18,8190,2,0,87,2,3.12166,5215,1816,5237,0
225,2.62006,23,0,1,0,83.628,23,8189,1,0,117,1,3.82054,5216,1817,5238,0
187,2.17756,12,0,28,0,63.014,12,8189,28,0,57,3,4.25152,5244,1820,5266,0
199,2.3173,19,0,0,0,65.494,19,8189,0,0,101,0,4.90381,5244,1820,5266,0
93,1.08297,11,0,20,0,94.94,11,8189,20,0,36,1,5.00864,5264,1821,5286,0
180,2.09592,17,0,0,0,89.662,17,8191,0,0,94,0,4.72909,5264,1821,5286,0
228,2.655,22,0,2,0,67.929,22,8170,2,0,100,2,5.77741,5266,1823,5288,0
213,2.48034,17,0,22,0,66.734,17,8189,22,0,102,0,4.96205,5288,1823,5310,0
219,2.5502,22,0,1,0,91.003,22,8189,1,0,105,1,3.58758,5289,1824,5311,0
195,2.27077,26,0,2,0,110.599,26,8189,2,0,80,2,4.64755,5291,1826,5313,0
251,2.92274,29,0,4,0,89.112,29,8191,4,0,105,4,4.83392,5295,1830,5317,0
179,2.0843,17,0,30,0,62.596,17,8191,30,0,64,1,4.30976,5325,1831,5347,0
171,1.99136,14,0,17,0,52.081,14,8189,17,0,84,0,3.72736,5342,1831,5364,0
252,2.93451,21,0,1,0,61.634,21,8191,1,0,130,1,4.32141,5343,1832,5365,0
219,2.55015,25,0,2,0,80.189,25,8189,2,0,83,2,3.44781,5345,1834,5367,0
181,2.10763,13,0,29,0,82.016,13,8189,29,0,65,2,3.2032,5374,1836,5396,0
188,2.18916,8,0,19,0,57.562,8,8189,19,0,78,2,2.71398,5393,1838,5415,0
212,2.46863,17,0,0,0,57.902,17,8189,0,0,113,0,3.4711,5393,1838,5415,0
235,2.73655,22,0,4,0,78.275,22,8190,4,0,103,4,3.15661,5397,1842,5419,0
193,2.24753,7,0,28,0,49.405,7,8189,28,0,74,1,3.45946,5425,1843,5447,0
189,2.20087,15,0,0,0,48.174,15,8189,0,0,96,0,3.2265,5425,1843,5447,0
226,2.63183,3,0,22,0,66.883,3,8191,22,0,98,2,3.59923,5447,1845,5469,0
113,1.31582,11,0,3,0,60.783,11,8190,3,0,58,0,3.50605,5450,1845,5472,0
205,2.38702,18,0,0,0,52.359,18,8189,0,0,106,0,3.08672,5450,1845,5472,0
211,2.45707,23,0,0,0,108.787,23,8189,0,0,108,0,3.12166,5450,1845,5472,0
198,2.30581,3,0,32,0,89.783,3,8189,32,0,74,3,4.42624,5482,1848,5504,0
139,1.61858,12,0,0,0,49.898,12,8189,0,0,74,0,3.41286,5482,1848,5504,0
206,2.39891,18,0,1,0,65.761,18,8173,1,0,96,1,3.5177,5483,1849,5505,0
169,1.96799,15,0,18,0,59.693,15,8189,12,0,88,0,4.75238,5495,1849,5523,0
209,2.43355,3,0,21,0,70.972,3,8171,21,0,97,1,4.51942,5516,1850,5544,0
137,1.59529,14,0,0,0,72.72,14,8189,0,0,69,0,3.61088,5516,1850,5544,0
219,2.55019,20,0,1,0,71.627,20,8189,1,0,105,1,3.2265,5517,1851,5545,0
229,2.66662,25,0,2,0,91.989,25,8189,2,0,99,2,2.92365,5519,1853,5547,0
211,2.45682,28,0,5,0,121.089,28,8190,5,0,84,5,2.97024,5524,1858,5552,0
200,2.32893,16,0,32,0,55.837,16,8190,32,0,66,3,2.98189,5556,1861,5584,0
237,2.75949,21,0,2,0,69.444,21,8170,2,0,104,2,3.07507,5558,1863,5586,0
241,2.80631,26,0,2,0,94.352,26,8189,2,0,106,2,3.26144,5560,1865,5588,0
185,2.15426,14,0,30,0,76.035,14,8189,30,0,64,3,3.27309,5590,1868,5618,0
159,1.85148,19,0,0,0,94.176,19,8191,0,0,85,0,2.98189,5590,1868,5618,0
238,2.77156,24,0,1,0,88.719,24,8189,1,0,115,1,2.99354,5591,1869,5619,0
211,2.45674,28,0,3,0,103.438,28,8189,3,0,89,3,2.79552,5594,1872,5622,0
207,2.41054,30,0,3,0,103.013,30,8190,3,0,78,3,2.9353,5597,1875,5625,0
244,2.84118,33,0,5,0,113.01,33,8189,5,0,84,5,2.97024,5602,1880,5630,0
226,2.63176,35,0,9,0,110.659,35,8175,9,0,66,9,2.90035,5611,1889,5639,0
233,2.7132,36,0,6,0,108.346,36,8190,6,0,58,6,2.95859,5617,1895,5645,0
204,2.37548,38,0,6,0,126.242,38,8191,6,0,51,6,3.16826,5623,1901,5651,0
256,2.98097,40,0,4,0,125.209,40,8189,4,0,96,4,3.37792,5627,1905,5655,0
231,2.6898,42,0,3,0,134.654,42,8190,3,0,60,3,3.40122,5630,1908,5658,0
226,2.63176,43,0,6,0,126.547,43,8191,6,0,53,6,5.07853,5636,1914,5664,0
286,3.33054,46,0,0,0,148.602,46,8189,0,0,147,0,5.5095,5636,1914,5664,0
272,3.16732,48,0,9,0,120.203,48,8189,9,0,74,9,4.9271,5645,1923,5673,0
165,1.92128,48,0,55,0,147.654,2,8181,55,0,23,7,4.83392,5700,1930,5728,0
157,1.82834,25,0,3,0,96.03,25,8189,3,0,61,3,4.93875,5703,1933,5731,0
222,2.58516,28,0,4,0,89.777,28,8163,4,0,75,4,4.21658,5707,1937,5735,0
239,2.78338,31,0,3,0,97.913,31,8191,3,0,108,3,4.85722,5710,1940,5738,0
161,1.87474,9,0,36,0,114.78,9,8191,36,0,46,3,5.35808,5746,1943,5774,0
203,2.36382,20,0,1,0,78.263,20,8189,1,0,93,1,5.67258,5747,1944,5775,0
214,2.4919,11,0,26,0,70.04,11,8189,26,0,88,3,5.14842,5773,1947,5801,0
206,2.39885,18,0,0,0,69.791,18,8191,0,0,108,0,6.25498,5773,1947,5801,0


