SendPacket,SendRate(Mb/s),FlightSize,ReceiveRate(Mb/s),Send Loss,Recv Loss,RTT(ms),CWnd,FlowWindow,Retrans,PktSndPeriod(us),RecvACK,RecvNAK,EstimatedBandwidth(Mb/s),Retrans_Total,NAK_TotalRecv,Total Send Loss,Total Recv Loss
307,3.2199,63,0,5,0,122.04,65,8190,5,0,80,5,10.5414,5,5,5,0
258,3.00437,73,0,90,0,155.877,2,8183,75,0,17,17,9.64454,80,22,95,0
278,3.2377,37,0,5,0,80.36,37,8191,20,0,85,5,6.59277,100,27,100,0
303,3.5285,59,0,6,0,142.215,69,8189,6,0,76,6,5.39302,106,33,106,0
239,2.78316,4,0,85,0,144.793,4,8190,68,0,18,9,5.35808,174,42,191,0
273,3.17907,4,0,61,0,102.221,4,8190,61,0,64,4,5.13677,235,46,252,0
254,2.95781,30,0,5,0,91.586,30,8190,5,0,93,5,5.00864,240,51,257,0
315,3.66818,34,0,4,0,100.055,34,8191,4,0,117,4,4.30976,244,55,261,0
293,3.41194,36,0,9,0,92.837,36,8156,9,0,83,9,4.44954,253,64,270,0
286,3.33057,3,0,49,0,93.296,3,8148,49,0,69,6,4.6592,302,70,319,0
277,3.22578,25,0,2,0,59.87,25,8191,2,0,113,2,5.07853,304,72,321,0
260,3.02774,28,0,5,0,67.249,28,8190,5,0,88,5,4.56602,309,77,326,0
182,2.11938,12,0,31,0,31.436,12,8191,31,0,79,0,4.58931,340,77,357,0
262,3.05096,20,0,0,0,55.07,20,8189,0,0,134,0,4.88051,340,77,357,0
262,3.05103,13,0,25,0,38.801,13,8189,25,0,107,2,5.62598,365,79,382,0
299,3.48179,21,0,22,0,61.134,2,8189,22,0,139,1,5.12512,387,80,404,0
235,2.73668,17,0,0,0,52.894,17,8189,0,0,119,0,4.99699,387,80,404,0
259,3.01628,3,0,25,0,58.137,3,8168,25,0,110,2,4.51942,412,82,429,0
258,3.00447,19,0,0,0,56.944,19,8189,0,0,128,0,4.49613,412,82,429,0
291,3.38866,24,0,2,0,68.227,24,8191,2,0,130,2,4.69414,414,84,431,0
274,3.19067,28,0,4,0,80.789,28,8190,4,0,106,4,4.77568,418,88,435,0
317,3.69145,32,0,5,0,96.557,32,8189,5,0,109,5,5.10182,423,93,440,0
305,3.55172,35,0,6,0,89.547,35,8191,6,0,109,6,3.92538,429,99,446,0
304,3.54006,38,0,9,0,102.866,38,8191,9,0,88,9,3.50605,438,108,455,0
219,2.55034,27,0,56,0,72.818,27,8191,56,0,65,2,3.2265,494,110,511,0
279,3.24909,30,0,5,0,89.752,30,8191,5,0,92,5,3.59923,499,115,516,0
269,3.13249,18,0,33,0,47.466,18,8189,33,0,103,2,4.03021,532,117,549,0
293,3.41196,24,0,3,0,61.638,24,8190,3,0,129,3,4.9504,535,120,552,0
248,2.88792,3,0,30,0,73.976,3,8191,30,0,79,3,4.9504,565,123,582,0
276,3.21398,20,0,1,0,61.678,20,8191,1,0,129,1,4.71744,566,124,583,0
257,2.99274,15,0,23,0,41.708,15,8189,23,0,118,1,4.6359,589,125,606,0
292,3.40036,22,0,1,0,68.842,22,8189,1,0,139,1,4.35635,590,126,607,0
280,3.26084,13,0,30,0,60.99,13,8191,30,0,102,4,6.68595,620,130,637,0
300,3.4937,21,0,0,0,53.882,21,8191,0,0,152,0,5.71917,620,130,637,0
270,3.1443,12,0,28,0,56.626,12,8191,28,0,104,3,4.88051,648,133,665,0
306,3.56338,21,0,0,0,59.111,21,8191,0,0,154,0,4.6825,648,133,665,0
289,3.36542,26,0,6,0,69.886,26,8191,6,0,114,6,4.58931,654,139,671,0
306,3.56354,28,0,5,0,70.336,30,8189,5,0,120,5,4.77568,659,144,676,0
283,3.2954,33,0,6,0,78.343,33,8191,6,0,97,6,5.5095,665,150,682,0
282,3.2837,36,0,7,0,86.842,36,8190,7,0,99,7,5.18336,672,157,689,0
336,3.91266,54,0,8,0,97.967,57,8190,8,0,92,8,6.03366,680,165,697,0
309,3.59824,69,0,12,0,143.049,72,8173,12,0,30,12,6.15014,692,177,709,0
173,2.01464,24,0,80,0,74.632,24,8189,72,0,24,7,6.65101,764,184,789,0
211,2.45694,17,0,40,0,78.472,17,8189,40,0,61,4,6.34816,804,188,829,0
267,3.10909,23,0,4,0,60.02,23,8189,4,0,111,4,5.67258,808,192,833,0
237,2.75973,17,0,23,0,54.838,17,8191,23,0,105,0,4.41459,831,192,856,0
279,3.24887,23,0,2,0,57.875,23,8189,2,0,127,2,3.65747,833,194,858,0
291,3.38834,28,0,4,0,75.119,28,8191,4,0,115,4,3.89043,837,198,862,0
249,2.89978,16,0,33,0,41.223,16,8191,33,0,94,3,3.42451,870,201,895,0
264,3.07455,14,0,20,0,35.963,14,8189,20,0,122,1,3.68077,890,202,915,0
289,3.36536,22,0,1,0,56.949,22,8189,1,0,147,1,4.08845,891,203,916,0
275,3.20213,18,0,22,0,47.698,18,8189,22,0,126,0,3.1799,913,203,938,0
320,3.72631,25,0,2,0,65.112,25,8189,2,0,145,2,3.12166,915,205,940,0
280,3.2606,18,0,27,0,46.991,18,8189,27,0,124,1,3.23814,942,206,967,0
295,3.43529,24,0,4,0,68.78,24,8189,4,0,115,4,4.03021,946,210,971,0
277,3.22563,28,0,5,0,74.341,28,8189,5,0,107,5,5.02029,951,215,976,0
278,3.23727,18,0,30,0,42.576,18,8191,30,0,120,1,5.28819,981,216,1006,0
309,3.59842,25,0,1,0,60.715,25,8189,1,0,146,1,5.11347,982,217,1007,0
316,3.67966,29,0,5,0,66.808,29,8189,5,0,123,5,5.83565,987,222,1012,0
308,3.58664,33,0,5,0,95.251,33,8191,5,0,129,5,6.70925,992,227,1017,0
262,3.05094,17,0,41,0,49.486,17,8191,41,0,77,6,6.53453,1033,233,1058,0
228,2.65519,14,0,20,0,40.46,14,8189,20,0,104,1,6.83738,1053,234,1078,0
336,3.91289,23,0,0,0,63.283,23,8189,0,0,169,0,6.06861,1053,234,1078,0
191,2.22406,12,0,27,0,39.584,12,8191,27,0,84,1,5.8473,1080,235,1105,0
270,3.14428,20,0,0,0,60.389,20,8191,0,0,136,0,6.06861,1080,235,1105,0
308,3.5867,26,0,2,0,74.323,26,8189,2,0,141,2,5.00864,1082,237,1107,0
303,3.52849,30,0,8,0,94.373,30,8191,8,0,113,8,4.89216,1090,245,1115,0
297,3.4587,34,0,6,0,87.848,34,8190,6,0,109,6,4.58931,1096,251,1121,0
299,3.48187,36,0,5,0,91.089,36,8190,5,0,89,5,4.58931,1101,256,1126,0
205,2.38692,9,0,43,0,33.527,9,8189,43,0,67,3,5.64928,1144,259,1169,0
296,3.44684,20,0,0,0,49.57,20,8189,0,0,152,0,6.73254,1144,259,1169,0
275,3.20235,5,0,28,0,70.375,5,8191,28,0,108,4,6.25498,1172,263,1197,0
318,3.70307,20,0,1,0,55.704,20,8171,1,0,150,1,6.65101,1173,264,1198,0
286,3.33043,25,0,3,0,73.236,25,8191,3,0,115,3,4.93875,1176,267,1201,0
298,3.47024,29,0,4,0,71.123,29,8191,4,0,114,4,4.27482,1180,271,1205,0
285,3.31874,33,0,4,0,87.336,33,8189,4,0,103,4,3.86714,1184,275,1209,0
272,3.16742,20,0,36,0,57.132,20,8189,36,0,116,3,3.62253,1220,278,1245,0
321,3.73818,26,0,1,0,63.553,26,8191,1,0,147,1,3.45946,1221,279,1246,0
277,3.22585,30,0,4,0,87.09,30,8189,4,0,92,4,3.70406,1225,283,1250,0
329,3.83172,34,0,4,0,76.358,34,8191,4,0,138,4,4.3447,1229,287,1254,0
257,2.99277,3,0,40,0,89.709,3,8155,40,0,76,4,4.32141,1269,291,1294,0
276,3.21408,22,0,2,0,72.961,22,8169,2,0,116,2,5.12512,1271,293,1296,0
260,3.02788,16,0,24,0,38.799,17,8189,24,0,117,1,5.17171,1295,294,1320,0
312,3.63322,23,0,3,0,64.892,23,8191,3,0,133,3,5.17171,1298,297,1323,0
227,2.6434,14,0,27,0,47.051,14,8191,27,0,89,2,4.88051,1325,299,1350,0
305,3.55175,22,0,1,0,51.672,22,8190,1,0,148,1,4.86886,1326,300,1351,0
324,3.773,28,0,4,0,67.013,28,8189,4,0,141,4,4.40294,1330,304,1355,0
301,3.50516,31,0,5,0,87.62,31,8190,5,0,114,5,5.10182,1335,309,1360,0
331,3.85444,35,0,4,0,98.59,35,8191,4,0,104,4,5.52115,1339,313,1364,0
316,3.67977,46,0,6,0,101.474,46,8179,6,0,118,6,5.88224,1345,319,1370,0
294,3.42373,31,0,64,0,68.782,31,8189,64,0,61,4,5.43962,1409,323,1434,0
236,2.74802,33,0,5,0,84.422,33,8190,5,0,80,5,4.69414,1414,328,1439,0
293,3.41207,21,0,33,0,63.836,21,8189,33,0,127,0,4.27482,1447,328,1472,0
290,3.37686,26,0,4,0,67.186,26,8190,4,0,118,4,4.70579,1451,332,1476,0
241,2.8065,8,0,32,0,82.072,8,8191,32,0,68,3,4.47283,1483,335,1508,0
275,3.20243,21,0,0,0,50.533,21,8189,0,0,139,0,4.96205,1483,335,1508,0
293,3.41214,27,0,1,0,75.778,27,8190,1,0,150,1,4.6359,1484,336,1509,0
251,2.923,19,0,27,0,53.325,19,8191,27,0,112,0,4.62426,1511,336,1536,0
330,3.84275,25,0,2,0,58.496,25,8189,2,0,151,2,4.86886,1513,338,1538,0
323,3.76126,30,0,2,0,72.259,30,8189,2,0,139,2,5.70752,1515,340,1540,0
265,3.08582,18,0,35,0,46.927,18,8189,35,0,102,3,5.25325,1550,343,1575,0
292,3.40026,24,0,2,0,78.802,24,8190,2,0,142,2,4.96205,1552,345,1577,0
291,3.38861,29,0,3,0,75.774,29,8191,3,0,125,3,4.47283,1555,348,1580,0
300,3.49343,32,0,3,0,93.554,32,8189,3,0,100,3,3.63418,1558,351,1583,0
292,3.40025,35,0,6,0,79.053,35,8191,6,0,100,6,4.03021,1564,357,1589,0
298,3.47023,21,0,38,0,49.098,21,8189,38,0,112,2,4.62426,1602,359,1627,0
309,3.59831,28,0,1,0,68,28,8189,1,0,156,1,5.68422,1603,360,1628,0
307,3.57499,31,0,3,0,75.66,31,8160,3,0,102,3,5.78906,1606,363,1631,0
279,3.24872,34,0,4,0,91.19,34,8158,4,0,84,4,5.40467,1610,367,1635,0
317,3.6915,23,0,35,0,61.978,23,8191,35,0,144,1,5.5095,1645,368,1670,0
271,3.15591,28,0,2,0,78.988,28,8190,2,0,130,2,5.09018,1647,370,1672,0
291,3.38897,32,0,3,0,90.619,32,8189,3,0,109,3,5.90554,1650,373,1675,0
270,3.14413,35,0,7,0,95.242,35,8189,7,0,107,7,6.9655,1657,380,1682,0
312,3.6332,41,0,7,0,103.003,41,8191,7,0,107,7,6.7209,1664,387,1689,0
279,3.24891,78,0,8,0,148.954,78,8191,8,0,70,8,6.02202,1672,395,1697,0
350,4.07579,90,0,13,0,123.727,90,8189,13,0,30,13,5.57939,1685,408,1710,0
375,4.36706,92,0,12,0,222.846,109,8166,12,0,60,12,6.83738,1697,420,1722,0
143,1.66529,15,0,120,0,142.797,15,8189,72,0,15,10,6.01037,1769,430,1842,0
384,4.47164,70,0,10,0,146.01,70,8191,10,0,77,10,5.78906,1779,440,1852,0
326,3.79628,67,0,9,0,144.489,87,8191,9,0,42,9,4.86886,1788,449,1861,0
176,2.04948,14,0,96,0,132.391,14,8190,94,0,20,6,4.78733,1882,455,1957,0
327,3.80796,71,0,8,0,165.725,72,8189,8,0,84,8,5.99872,1890,463,1965,0
236,2.74828,1,0,95,0,168.686,3,8191,68,0,37,8,7.04704,1958,471,2060,0
312,3.63342,65,0,5,0,157.307,74,8189,5,0,98,5,6.37146,1963,476,2065,0
213,2.48033,5,0,94,0,171.297,5,8189,72,0,27,11,5.57939,2035,487,2159,0
213,2.48048,19,0,39,0,83.253,19,8191,39,0,68,1,5.10182,2074,488,2198,0
248,2.88814,15,0,23,0,34.821,15,8191,23,0,113,1,5.2649,2097,489,2221,0
259,3.0162,10,0,21,0,49.325,10,8189,21,0,118,1,5.83565,2118,490,2242,0
232,2.70157,18,0,0,0,53.771,18,8189,0,0,117,0,6.63936,2118,490,2242,0
306,3.56348,25,0,2,0,67.108,25,8191,2,0,140,2,6.17344,2120,492,2244,0
282,3.28387,29,0,2,0,99.938,29,8189,2,0,120,2,5.32314,2122,494,2246,0
191,2.22416,15,0,33,0,82.362,15,8189,33,0,63,2,4.86886,2155,496,2279,0
293,3.41215,22,0,1,0,53.518,22,8191,1,0,142,1,5.49786,2156,497,2280,0
245,2.8531,27,0,1,0,86.89,27,8189,1,0,116,1,5.99872,2157,498,2281,0
254,2.95782,15,0,31,0,42.695,15,8191,31,0,101,2,5.60269,2188,500,2312,0
249,2.89973,22,0,1,0,75.499,22,8189,1,0,118,1,5.88224,2189,501,2313,0
277,3.22573,3,0,28,0,69.699,3,8191,28,0,118,2,5.25325,2217,503,2341,0
210,2.44558,18,0,0,0,58.014,18,8189,0,0,105,0,4.77568,2217,503,2341,0
253,2.94623,24,0,1,0,80.12,24,8191,1,0,131,1,5.14842,2218,504,2342,0
223,2.5968,17,0,24,0,81.488,17,8190,24,0,99,0,5.41632,2242,504,2366,0
287,3.34205,11,0,24,0,64.618,11,8189,24,0,133,1,4.81062,2266,505,2390,0
217,2.52694,18,0,1,0,54.232,18,8191,1,0,104,1,4.84557,2267,506,2391,0
226,2.63195,11,0,23,0,70.196,11,8189,23,0,103,1,5.06688,2290,507,2414,0
234,2.72509,19,0,0,0,64.385,19,8191,0,0,122,0,5.18336,2290,507,2414,0
269,3.1327,25,0,0,0,101.346,25,8189,0,0,139,0,6.3831,2290,507,2414,0
271,3.15609,30,0,1,0,81.252,30,8189,1,0,127,1,7.03539,2291,508,2415,0
257,2.99274,3,0,35,0,92.987,3,8191,35,0,101,2,6.68595,2326,510,2450,0
302,3.51673,22,0,0,0,65.026,22,8191,0,0,149,0,5.36973,2326,510,2450,0
276,3.21399,27,0,2,0,81.782,27,8189,2,0,121,2,4.21658,2328,512,2452,0
215,2.50365,16,0,29,0,55.191,16,8189,29,0,92,1,4.44954,2357,513,2481,0
288,3.35376,23,0,1,0,61.173,23,8169,1,0,138,1,4.43789,2358,514,2482,0
309,3.59829,3,0,33,0,70.645,3,8166,33,0,120,5,5.27654,2391,519,2515,0
236,2.74827,20,0,0,0,47.685,20,8191,0,0,116,0,4.58931,2391,519,2515,0
227,2.64347,13,0,24,0,37.628,13,8189,24,0,101,1,3.71571,2415,520,2539,0
273,3.17906,21,0,1,0,57.852,21,8190,1,0,139,1,3.24979,2416,521,2540,0
255,2.96968,8,0,27,0,69.223,8,8191,27,0,96,2,3.28474,2443,523,2567,0
267,3.10924,20,0,0,0,46.91,20,8189,0,0,135,0,3.91373,2443,523,2567,0
275,3.20256,3,0,26,0,73.97,3,8167,26,0,125,1,4.51942,2469,524,2593,0
243,2.82967,19,0,0,0,53.015,19,8191,0,0,123,0,5.5095,2469,524,2593,0
273,3.17907,24,0,2,0,65.286,24,8191,2,0,122,2,4.47283,2471,526,2595,0
314,3.65673,29,0,4,0,74.816,29,8189,4,0,133,4,4.41459,2475,530,2599,0
275,3.20256,6,0,36,0,84.663,6,8189,36,0,80,4,4.32141,2511,534,2635,0
243,2.8298,21,0,1,0,71.951,21,8189,1,0,116,1,4.15834,2512,535,2636,0
275,3.20232,26,0,3,0,74.537,26,8189,3,0,110,3,5.61434,2515,538,2639,0
316,3.6798,30,0,6,0,75.368,30,8191,6,0,112,6,4.72909,2521,544,2645,0
283,3.29591,33,0,3,0,79.473,33,8189,3,0,103,3,5.05523,2524,547,2648,0
303,3.52852,9,0,40,0,93.677,3,8164,40,0,104,4,4.3447,2564,551,2688,0
260,3.02794,23,0,1,0,55.731,23,8189,1,0,119,1,3.75066,2565,552,2689,0
242,2.81816,26,0,3,0,94.171,26,8189,3,0,90,3,4.15834,2568,555,2692,0
327,3.80796,31,0,3,0,77.379,31,8189,3,0,143,3,5.20666,2571,558,2695,0
283,3.29425,33,0,6,0,101.635,34,8189,6,0,100,6,5.74246,2577,564,2701,0
292,3.40039,37,0,5,0,95.332,37,8189,5,0,98,5,6.4297,2582,569,2706,0
288,3.35369,69,0,5,0,154.063,69,8189,5,0,77,5,5.71917,2587,574,2711,0
437,5.08877,98,0,6,0,141.16,100,8189,6,0,82,6,5.54445,2593,580,2717,0
319,3.71423,115,0,15,0,188.462,115,8177,15,0,52,15,6.60442,2608,595,2732,0
118,1.37415,12,0,117,0,169.969,12,8189,90,0,10,2,7.05869,2698,597,2849,0
267,3.10927,70,0,8,0,127.951,70,8190,8,0,81,8,7.53626,2706,605,2857,0
343,3.99436,86,0,25,0,160.853,86,8184,25,0,39,25,6.86067,2731,630,2882,0
149,1.73508,24,0,90,0,101.134,24,8189,90,0,22,4,4.55437,2821,634,2972,0
314,3.65647,73,0,12,0,140.279,73,8172,12,0,75,12,5.2416,2833,646,2984,0
219,2.55026,11,0,111,0,77.231,11,8189,96,0,45,2,4.85722,2929,648,3095,0
216,2.51511,5,0,23,0,73.477,5,8190,23,0,99,1,4.77568,2952,649,3118,0
234,2.72496,18,0,0,0,54.388,18,8189,0,0,116,0,5.11347,2952,649,3118,0
201,2.34072,13,0,21,0,35.309,13,8189,21,0,86,1,5.43962,2973,650,3139,0
217,2.52683,20,0,0,0,89.224,20,8189,0,0,114,0,5.70752,2973,650,3139,0
264,3.07441,12,0,25,0,53.024,12,8189,25,0,119,1,6.06861,2998,651,3164,0
281,3.27223,20,0,1,0,60.677,20,8190,1,0,143,1,4.56602,2999,652,3165,0
209,2.43384,14,0,22,0,53.934,14,8189,22,0,85,1,4.42624,3021,653,3187,0
243,2.82965,21,0,0,0,110.633,21,8191,0,0,126,0,4.70579,3021,653,3187,0
265,3.08577,25,0,3,0,74.226,25,8189,3,0,103,3,4.47283,3024,656,3190,0
268,3.12078,30,0,2,0,88.59,30,8189,2,0,113,2,4.49613,3026,658,3192,0
261,3.03926,32,0,3,0,84.814,32,8189,3,0,89,3,4.40294,3029,661,3195,0
315,3.6684,36,0,6,0,101.162,36,8191,6,0,112,6,3.99526,3035,667,3201,0
296,3.44692,53,0,6,0,100.704,53,8191,6,0,93,6,4.41459,3041,673,3207,0
338,3.93594,77,0,11,0,171.285,80,8189,11,0,56,11,5.09018,3052,684,3218,0
184,2.1427,30,0,89,0,70.506,30,8189,65,0,37,6,5.10182,3117,690,3307,0
166,1.93305,10,0,42,0,40.043,10,8190,42,0,60,1,4.91546,3159,691,3349,0
229,2.66666,9,0,17,0,72.309,9,8191,17,0,111,0,5.19501,3176,691,3366,0
211,2.45709,17,0,1,0,66.75,17,8191,1,0,110,1,5.07853,3177,692,3367,0
300,3.4935,23,0,2,0,61.347,23,8189,2,0,130,2,4.51942,3179,694,3369,0
223,2.59685,16,0,25,0,68.019,16,8191,25,0,98,1,4.82227,3204,695,3394,0
327,3.80785,24,0,0,0,70.516,24,8189,0,0,166,0,4.85722,3204,695,3394,0
223,2.597,14,0,27,0,63.11,16,8189,27,0,99,1,4.9271,3231,696,3421,0
246,2.86457,22,0,1,0,72.335,22,8189,1,0,118,1,5.33478,3232,697,3422,0
273,3.17905,8,0,28,0,85.597,8,8189,28,0,125,1,5.39302,3260,698,3450,0
284,3.30737,21,0,0,0,60.426,21,8189,0,0,143,0,4.96205,3260,698,3450,0
242,2.81812,25,0,2,0,78.084,25,8191,2,0,111,2,4.84557,3262,700,3452,0
292,3.4005,29,0,3,0,74.512,29,8190,3,0,114,3,5.06688,3265,703,3455,0
178,2.07277,3,0,39,0,92.07,3,8191,39,0,72,1,5.52115,3304,704,3494,0
77,0.896702,5,0,8,0,77.525,5,8191,8,0,39,0,5.98707,3312,704,3502,0
139,1.61863,6,0,12,0,57.45,6,8191,12,0,68,0,5.48621,3324,704,3514,0
102,1.1878,12,0,0,0,95.444,12,8187,0,0,54,0,5.70752,3324,704,3514,0
239,2.78317,19,0,0,0,79.613,19,8191,0,0,125,0,5.83565,3324,704,3514,0
279,3.24883,25,0,1,0,64.31,25,8189,1,0,132,1,6.20838,3325,705,3515,0
265,3.0858,9,0,31,0,92.47,9,8189,31,0,106,2,4.93875,3356,707,3546,0
263,3.0626,3,0,21,0,55.573,3,8191,21,0,122,1,5.45126,3377,708,3567,0
247,2.87652,18,0,0,0,53.867,18,8189,0,0,121,0,4.71744,3377,708,3567,0
276,3.21403,24,0,0,0,81.31,24,8191,0,0,140,0,4.1001,3377,708,3567,0
318,3.70303,30,0,2,0,93.729,30,8189,2,0,148,2,4.69414,3379,710,3569,0
200,2.32896,18,0,31,0,66.474,18,8191,31,0,85,1,5.20666,3410,711,3600,0
266,3.09765,24,0,0,0,76.647,24,8191,0,0,136,0,5.38138,3410,711,3600,0
246,2.86478,14,0,29,0,54.862,14,8191,29,0,95,2,6.23168,3439,713,3629,0
233,2.71341,20,0,1,0,59.894,20,8191,1,0,112,1,5.46291,3440,714,3630,0
270,3.14418,26,0,1,0,84.886,26,8189,1,0,128,1,4.6825,3441,715,3631,0
261,3.03929,29,0,4,0,87.883,29,8189,4,0,96,4,4.60096,3445,719,3635,0
278,3.23723,33,0,5,0,90.614,33,8190,5,0,115,5,4.35635,3450,724,3640,0
267,3.1092,18,0,38,0,117.649,18,8189,38,0,81,4,4.9737,3488,728,3678,0
192,2.23581,5,0,23,0,66.996,5,8191,23,0,89,1,5.14842,3511,729,3701,0
207,2.41047,17,0,0,0,75.477,17,8189,0,0,106,0,5.62598,3511,729,3701,0
265,3.08589,24,0,0,0,114.182,24,8189,0,0,135,0,5.68422,3511,729,3701,0
220,2.56181,13,0,28,0,82.714,13,8189,28,0,82,2,5.8007,3539,731,3729,0
279,3.24893,21,0,1,0,52.583,21,8191,1,0,133,1,5.12512,3540,732,3730,0
292,3.4004,26,0,2,0,69.952,26,8189,2,0,126,2,5.40467,3542,734,3732,0
280,3.26011,30,0,4,0,112.474,30,8191,4,0,117,4,4.91546,3546,738,3736,0
270,3.14404,7,0,37,0,78.387,7,8189,37,0,90,4,4.6825,3583,742,3773,0
220,2.56197,21,0,0,0,73.995,21,8191,0,0,110,0,5.02029,3583,742,3773,0
207,2.41063,3,0,29,0,72.787,3,8189,29,0,92,1,5.22995,3612,743,3802,0
209,2.43384,15,0,0,0,45.881,15,8189,0,0,108,0,6.35981,3612,743,3802,0
245,2.85316,21,0,0,0,58.203,21,8189,0,0,126,0,7.8624,3612,743,3802,0
266,3.09778,26,0,3,0,83.955,26,8168,3,0,103,3,8.22349,3615,746,3805,0
240,2.7948,13,0,33,0,72.958,13,8191,33,0,92,4,7.8624,3648,750,3838,0
303,3.52837,22,0,0,0,54.924,22,8191,0,0,150,0,7.19846,3648,750,3838,0
248,2.8878,26,0,1,0,78.429,26,8191,1,0,117,1,5.89389,3649,751,3839,0
217,2.52703,15,0,32,0,70.601,15,8191,32,0,81,4,6.32486,3681,755,3871,0
259,3.01607,22,0,1,0,76.397,22,8189,1,0,126,1,5.66093,3682,756,3872,0
267,3.10919,26,0,3,0,74.212,26,8189,3,0,104,3,5.56774,3685,759,3875,0
203,2.36394,15,0,30,0,52.905,15,8189,30,0,73,3,5.2416,3715,762,3905,0
216,2.51543,21,0,1,0,74.62,21,8170,1,0,104,1,5.39302,3716,763,3906,0
287,3.34204,26,0,1,0,74.394,26,8189,1,0,139,1,5.36973,3717,764,3907,0
190,2.21252,17,0,28,0,54.193,17,8191,28,0,77,1,4.67085,3745,765,3935,0
287,3.34216,24,0,0,0,58.592,24,8189,0,0,148,0,4.3913,3745,765,3935,0
291,3.38881,28,0,3,0,81.15,28,8189,3,0,113,3,4.0535,3748,768,3938,0
304,3.54011,33,0,1,0,88.18,33,8189,1,0,143,1,4.67085,3749,769,3939,0
271,3.15582,36,0,4,0,94.976,36,8191,4,0,105,4,4.9271,3753,773,3943,0
262,3.05074,22,0,38,0,58.705,22,8190,38,0,98,2,5.16006,3791,775,3981,0
220,2.56185,17,0,22,0,42.13,17,8189,22,0,97,0,5.11347,3813,775,4003,0
273,3.17903,23,0,3,0,69.749,23,8191,3,0,125,3,5.17171,3816,778,4006,0
272,3.16734,27,0,4,0,73.651,27,8191,4,0,110,4,6.27827,3820,782,4010,0
269,3.13268,29,0,3,0,89.412,31,8189,3,0,97,3,6.7209,3823,785,4013,0
222,2.5851,19,0,32,0,48.544,19,8189,32,0,96,1,6.58112,3855,786,4045,0
276,3.21409,25,0,0,0,63.699,25,8189,0,0,142,0,6.28992,3855,786,4045,0
239,2.78313,3,0,31,0,87.437,3,8162,31,0,97,2,5.87059,3886,788,4076,0
174,2.02618,13,0,3,0,43.109,13,8189,3,0,87,0,5.56774,3889,788,4079,0
270,3.14421,21,0,0,0,62.582,21,8191,0,0,138,0,4.77568,3889,788,4079,0
301,3.5048,27,0,1,0,77.992,27,8189,1,0,143,1,5.16006,3890,789,4080,0
254,2.95766,16,0,30,0,46.764,16,8189,30,0,112,1,5.60269,3920,790,4110,0
273,3.17913,23,0,0,0,66.772,23,8187,0,0,141,0,5.49786,3920,790,4110,0
304,3.54015,28,0,2,0,72.001,28,8189,2,0,131,2,6.39475,3922,792,4112,0
158,1.83988,7,0,40,0,94.417,7,8189,40,0,62,1,6.04531,3962,793,4152,0
198,2.30568,16,0,0,0,70.564,16,8189,0,0,105,0,5.42797,3962,793,4152,0
280,3.26063,23,0,0,0,68.575,23,8191,0,0,141,0,4.9737,3962,793,4152,0
228,2.65479,13,0,27,0,83.341,13,8191,27,0,103,1,5.04358,3989,794,4179,0
261,3.0393,21,0,0,0,68.208,21,8189,0,0,136,0,4.26317,3989,794,4179,0
202,2.35229,16,0,22,0,40.856,16,8189,22,0,89,1,4.16998,4011,795,4201,0
289,3.36533,23,0,2,0,61.756,23,8190,2,0,142,2,4.22822,4013,797,4203,0
229,2.66666,12,0,27,0,67.211,12,8189,27,0,79,2,3.73901,4040,799,4230,0
265,3.08583,20,0,0,0,59.621,20,8191,0,0,135,0,4.70579,4040,799,4230,0
281,3.27223,26,0,1,0,71.736,26,8189,1,0,130,1,5.2649,4041,800,4231,0
274,3.1907,30,0,1,0,93.639,30,8189,1,0,130,1,5.2416,4042,801,4232,0
266,3.09758,33,0,2,0,88.222,33,8191,2,0,106,2,5.17171,4044,803,4234,0
205,2.38721,19,0,35,0,61.65,19,8191,35,0,80,1,5.35808,4079,804,4269,0
239,2.78326,9,0,25,0,59.964,9,8191,25,0,109,1,4.14669,4104,805,4294,0
240,2.79492,19,0,0,0,52.195,19,8191,0,0,122,0,4.53107,4104,805,4294,0
274,3.19067,25,0,2,0,66.157,25,8190,2,0,131,2,5.19501,4106,807,4296,0
241,2.80642,4,0,34,0,79.821,4,8189,34,0,106,1,4.91546,4140,808,4330,0
52,0.605534,6,0,6,0,85.284,6,8190,6,0,26,0,4.9737,4146,808,4336,0
169,1.96805,14,0,0,0,50.59,14,8189,0,0,90,0,5.5328,4146,808,4336,0
211,2.45722,4,0,23,0,51.11,4,8191,23,0,95,1,5.42797,4169,809,4359,0
193,2.24748,14,0,0,0,39.097,14,8189,0,0,100,0,5.2649,4169,809,4359,0
270,3.14407,21,0,1,0,56.206,21,8191,1,0,130,1,5.92883,4170,810,4360,0
282,3.28393,26,0,3,0,71.047,26,8189,3,0,109,3,5.89389,4173,813,4363,0
322,3.7496,30,0,6,0,80.301,30,8161,6,0,121,6,5.5095,4179,819,4369,0
298,3.47002,34,0,37,0,89.473,2,8191,37,0,109,3,5.824,4216,822,4406,0
226,2.63173,21,0,1,0,86.693,21,8189,1,0,111,1,5.49786,4217,823,4407,0
291,3.38871,27,0,2,0,80.194,27,8189,2,0,148,2,5.52115,4219,825,4409,0
217,2.5272,18,0,27,0,46.983,18,8191,27,0,94,0,5.56774,4246,825,4436,0
261,3.03934,23,0,3,0,67.791,23,8190,3,0,115,3,5.13677,4249,828,4439,0
266,3.0977,28,0,1,0,88.73,28,8191,1,0,115,1,5.18336,4250,829,4440,0
291,3.38881,31,0,4,0,83.392,31,8189,4,0,95,4,4.79898,4254,833,4444,0
249,2.89968,19,0,33,0,50.588,19,8191,33,0,107,2,5.34643,4287,835,4477,0
230,2.67833,24,0,2,0,66.657,24,8190,2,0,107,2,4.67085,4289,837,4479,0
235,2.73657,18,0,24,0,76.777,18,8191,24,0,104,0,4.6592,4313,837,4503,0
278,3.23727,24,0,2,0,63.638,24,8189,2,0,122,2,4.55437,4315,839,4505,0
206,2.39885,7,0,30,0,40.152,7,8189,30,0,89,1,4.49613,4345,840,4535,0
223,2.59679,16,0,0,0,50.442,16,8189,0,0,115,0,4.16998,4345,840,4535,0
269,3.13243,23,0,2,0,61.022,23,8189,2,0,128,2,3.7623,4347,842,4537,0
245,2.85308,17,0,23,0,45.876,17,8191,23,0,109,0,4.19328,4370,842,4560,0
285,3.31892,24,0,1,0,59.896,24,8187,1,0,136,1,4.53107,4371,843,4561,0
231,2.68992,27,0,5,0,79.906,27,8191,5,0,81,5,5.39302,4376,848,4566,0
242,2.81821,30,0,2,0,87.544,30,8191,2,0,96,2,5.34643,4378,850,4568,0
317,3.69136,34,0,3,0,85.377,34,8191,3,0,120,3,5.62598,4381,853,4571,0
195,2.2707,9,0,40,0,97.446,9,8189,40,0,62,4,6.26662,4421,857,4611,0
271,3.15564,23,0,1,0,56.315,23,8189,1,0,123,1,4.9504,4422,858,4612,0
291,3.38883,28,0,1,0,111.28,28,8189,1,0,136,1,5.29984,4423,859,4613,0
296,3.44719,33,0,1,0,105.194,33,8190,1,0,152,1,4.96205,4424,860,4614,0
241,2.80641,14,0,37,0,92.092,14,8189,37,0,69,2,4.57766,4461,862,4651,0
232,2.70161,22,0,2,0,78.976,22,8189,2,0,107,2,4.75238,4463,864,4653,0
250,2.91123,26,0,3,0,76.542,26,8190,3,0,107,3,4.00691,4466,867,4656,0
168,1.95633,4,0,33,0,78.274,4,8190,33,0,48,2,3.58758,4499,869,4689,0
173,2.0139,14,0,0,0,63.565,14,8189,0,0,92,0,3.77395,4499,869,4689,0
248,2.88792,21,0,0,0,81.402,21,8189,0,0,127,0,3.4944,4499,869,4689,0
193,2.24757,12,0,25,0,81.183,12,8189,25,0,73,2,3.90208,4524,871,4714,0
252,2.93468,20,0,0,0,63.308,20,8189,0,0,128,0,4.57766,4524,871,4714,0
267,3.10921,25,0,1,0,76.697,25,8189,1,0,126,1,6.6743,4525,872,4715,0
257,2.99283,15,0,30,0,42.118,15,8189,30,0,98,2,7.79251,4555,874,4745,0
241,2.80654,21,0,0,0,58.938,21,8189,0,0,123,0,5.97542,4555,874,4745,0
305,3.55154,27,0,3,0,74.994,27,8191,3,0,132,3,4.9504,4558,877,4748,0
256,2.98101,31,0,0,0,86.897,31,8189,0,0,132,0,6.27827,4558,877,4748,0
320,3.72661,35,0,3,0,90.359,35,8191,3,0,117,3,5.69587,4561,880,4751,0
278,3.23748,42,0,4,0,106.516,42,8191,4,0,107,4,7.79251,4565,884,4755,0
333,3.87771,77,0,10,0,142.55,77,8189,10,0,67,10,6.80243,4575,894,4765,0
232,2.7016,7,0,94,0,188.867,7,8190,94,0,30,7,5.824,4669,901,4859,0
276,3.214,24,0,54,0,73.932,24,8189,54,0,77,5,5.33478,4723,906,4913,0
277,3.22571,3,0,30,0,76.484,3,8162,30,0,126,1,4.84557,4753,907,4943,0
134,1.56038,12,0,3,0,75.849,12,8191,3,0,69,0,4.9271,4756,907,4946,0
211,2.45708,19,0,0,0,64.927,19,8189,0,0,113,0,4.25152,4756,907,4946,0
300,3.49323,25,0,2,0,53.828,25,8191,2,0,134,2,4.14669,4758,909,4948,0
252,2.93458,29,0,2,0,85.323,29,8189,2,0,114,2,5.85894,4760,911,4950,0
279,3.24894,32,0,4,0,88.4,32,8176,4,0,87,4,5.76576,4764,915,4954,0
268,3.12098,19,0,34,0,60.485,19,8189,34,0,117,1,6.95386,4798,916,4988,0
293,3.41204,25,0,2,0,61.678,25,8189,2,0,130,2,6.31322,4800,918,4990,0
283,3.29546,29,0,3,0,98.036,29,8189,3,0,106,3,5.69587,4803,921,4993,0
261,3.03926,32,0,3,0,95.488,32,8191,3,0,105,3,6.28992,4806,924,4996,0
260,3.02767,19,0,34,0,61.99,19,8189,34,0,95,1,4.32141,4840,925,5030,0
278,3.2374,25,0,2,0,80.093,25,8191,2,0,124,2,3.90208,4842,927,5032,0
236,2.74822,14,0,28,0,48.6,14,8191,28,0,103,1,3.52934,4870,928,5060,0
237,2.75999,8,0,30,0,69.645,3,8189,30,0,112,0,3.97197,4900,928,5090,0
141,1.64196,13,0,0,0,44.295,13,8189,0,0,75,0,4.23987,4900,928,5090,0
97,1.12956,11,0,13,0,73.46,11,8191,13,0,48,0,4.50778,4913,928,5103,0
115,1.33915,11,0,11,0,44.106,11,8189,11,0,57,0,4.6825,4924,928,5114,0
190,2.21251,17,0,0,0,51.529,17,8191,0,0,96,0,5.43962,4924,928,5114,0
269,3.13239,24,0,1,0,83.875,24,8191,1,0,137,1,6.49958,4925,929,5115,0
262,3.05092,28,0,1,0,94.022,28,8190,1,0,114,1,5.68422,4926,930,5116,0
260,3.02762,3,0,35,0,76.633,3,8160,35,0,90,4,5.45126,4961,934,5151,0
112,1.30432,11,0,3,0,36.991,11,8189,3,0,57,0,5.06688,4964,934,5154,0
212,2.46874,18,0,0,0,53.828,18,8189,0,0,109,0,4.1001,4964,934,5154,0
193,2.24747,15,0,18,0,45.379,15,8190,18,0,95,0,4.19328,4982,934,5172,0
282,3.28387,23,0,0,0,58.783,23,8191,0,0,146,0,4.25152,4982,934,5172,0
263,3.06273,27,0,2,0,79.492,27,8191,2,0,114,2,4.79898,4984,936,5174,0
286,3.33065,31,0,5,0,72.847,31,8191,5,0,106,5,5.13677,4989,941,5179,0
246,2.86467,34,0,3,0,97.274,34,8189,3,0,97,3,5.62598,4992,944,5182,0
298,3.47015,37,0,3,0,97.314,37,8189,3,0,121,3,7.2567,4995,947,5185,0
293,3.41194,85,0,2,0,151.5,85,8191,2,0,107,2,7.60614,4997,949,5187,0
372,4.33194,92,0,15,0,152.514,92,8189,15,0,20,15,6.9888,5012,964,5202,0
210,2.44552,11,0,100,0,124.966,11,8189,100,0,14,6,6.3831,5112,970,5302,0
322,3.74958,62,0,4,0,154.067,70,8191,4,0,81,4,5.64928,5116,974,5306,0
199,2.3173,84,0,7,0,203.064,84,8157,7,0,35,7,5.05523,5123,981,5313,0
293,3.41192,60,0,87,0,80.187,60,8191,61,0,71,3,4.71744,5184,984,5400,0
373,4.34347,79,0,10,0,152.638,85,8189,10,0,57,10,4.64755,5194,994,5410,0
297,3.45856,97,0,27,0,173.082,97,8191,27,0,32,27,5.2183,5221,1021,5437,0
213,2.48028,18,0,121,0,116.782,18,8191,97,0,24,21,6.06861,5318,1042,5558,0
338,3.93592,6,0,134,0,117.945,6,8189,126,0,67,8,6.58112,5444,1050,5692,0
220,2.56182,33,0,7,0,85.011,33,8189,7,0,69,7,5.71917,5451,1057,5699,0
322,3.74987,36,0,5,0,85.496,36,8189,5,0,121,5,4.40294,5456,1062,5704,0
347,4.04091,75,0,5,0,139.137,75,8174,5,0,112,5,4.48448,5461,1067,5709,0
337,3.92456,75,0,10,0,192.979,102,8189,10,0,74,10,4.85722,5471,1077,5719,0
185,2.15427,12,0,112,0,144.473,12,8189,91,0,11,10,5.71917,5562,1087,5831,0
326,3.79637,65,0,10,0,126.431,65,8190,10,0,71,10,7.29165,5572,1097,5841,0
313,3.64481,80,0,5,0,186.235,87,8191,5,0,52,5,7.22176,5577,1102,5846,0
313,3.64488,98,0,19,0,206.804,98,8137,19,0,32,19,6.6743,5596,1121,5865,0
172,2.00288,41,0,101,0,67.26,41,8190,62,0,40,3,6.05696,5658,1124,5966,0
321,3.73802,78,0,9,0,124.988,78,8190,9,0,69,9,5.02029,5667,1133,5975,0
370,4.30865,97,0,9,0,143.008,97,8171,9,0,52,9,5.03194,5676,1142,5984,0
194,2.25894,14,0,108,0,114.411,14,8189,70,0,16,10,5.61434,5746,1152,6092,0
280,3.26055,67,0,5,0,130.587,67,8190,5,0,73,5,5.92883,5751,1157,6097,0
195,2.27073,10,0,80,0,138.867,10,8190,68,0,15,9,5.63763,5819,1166,6177,0
268,3.12081,17,0,39,0,50.636,17,8191,39,0,86,4,5.33478,5858,1170,6216,0
213,2.48026,23,0,0,0,66.508,23,8191,0,0,109,0,5.48621,5858,1170,6216,0
302,3.51699,28,0,1,0,67.804,28,8189,1,0,145,1,5.43962,5859,1171,6217,0
219,2.55036,15,0,32,0,87.169,15,8189,32,0,82,2,5.40467,5891,1173,6249,0
262,3.05108,21,0,2,0,54.382,21,8189,2,0,119,2,5.40467,5893,1175,6251,0
284,3.30715,26,0,2,0,68.035,26,8189,2,0,123,2,4.40294,5895,1177,6253,0
294,3.42356,30,0,4,0,81.672,30,8191,4,0,124,4,4.37965,5899,1181,6257,0
253,2.9462,33,0,4,0,79.298,33,8191,4,0,85,4,4.50778,5903,1185,6261,0
315,3.66809,37,0,2,0,94.931,37,8191,2,0,142,2,4.79898,5905,1187,6263,0
289,3.36533,68,0,10,0,125.233,68,8190,10,0,67,10,5.77741,5915,1197,6273,0
272,3.16742,88,0,14,0,181.354,88,8189,14,0,47,14,6.01037,5929,1211,6287,0
225,2.62014,54,0,90,0,118.104,54,8190,61,0,60,2,5.28819,5990,1213,6377,0
349,4.06409,84,0,6,0,156.759,85,8189,6,0,68,6,4.6825,5996,1219,6383,0
224,2.60846,89,0,19,0,189.867,89,8191,19,0,10,19,4.55437,6015,1238,6402,0
265,3.08581,54,0,94,0,80.34,54,8189,64,0,60,5,4.76403,6079,1243,6496,0
261,3.03928,29,0,55,0,89.881,29,8189,55,0,96,1,5.45126,6134,1244,6551,0
262,3.05102,32,0,5,0,72.108,32,8191,5,0,94,5,5.74246,6139,1249,6556,0
199,2.31735,16,0,34,0,65.402,16,8189,34,0,64,1,6.51123,6173,1250,6590,0
255,2.96937,23,0,1,0,66.51,23,8189,1,0,131,1,6.68595,6174,1251,6591,0
272,3.16753,27,0,3,0,81.643,27,8191,3,0,110,3,4.70579,6177,1254,6594,0
222,2.58534,19,0,27,0,53.205,19,8191,27,0,107,0,5.85894,6204,1254,6621,0
284,3.30723,25,0,0,0,69.697,25,8189,0,0,148,0,5.59104,6204,1254,6621,0
199,2.31734,17,0,26,0,67.31,17,8191,26,0,88,1,5.13677,6230,1255,6647,0
239,2.78313,23,0,0,0,77.164,23,8189,0,0,122,0,5.5328,6230,1255,6647,0
231,2.69017,13,0,29,0,68.421,13,8189,29,0,88,3,4.91546,6259,1258,6676,0
234,2.72498,9,0,19,0,66.475,9,8191,19,0,114,0,3.97197,6278,1258,6695,0
245,2.85307,18,0,0,0,56.808,18,8189,0,0,128,0,3.93702,6278,1258,6695,0
290,3.37701,24,0,3,0,62.357,24,8189,3,0,121,3,3.40122,6281,1261,6698,0
256,2.9811,27,0,4,0,69.403,27,8191,4,0,98,4,4.06515,6285,1265,6702,0
272,3.16733,31,0,35,0,91.411,2,8191,35,0,95,4,4.32141,6320,1269,6737,0
216,2.51529,19,0,1,0,61.408,19,8189,1,0,97,1,4.6592,6321,1270,6738,0
230,2.67831,24,0,2,0,67.46,24,8189,2,0,96,2,5.32314,6323,1272,6740,0
286,3.33069,27,0,2,0,86.86,28,8189,2,0,124,2,4.6359,6325,1274,6742,0
261,3.0394,31,0,5,0,83.922,31,8189,5,0,92,5,4.86886,6330,1279,6747,0
279,3.24818,30,0,6,0,99.698,34,8191,6,0,99,6,5.19501,6336,1285,6753,0
252,2.93459,36,0,6,0,111.506,36,8191,6,0,75,6,4.27482,6342,1291,6759,0
284,3.30717,61,0,5,0,143.133,65,8189,5,0,85,5,4.9271,6347,1296,6764,0
322,3.74964,79,0,17,0,176.142,85,8164,17,0,46,17,5.06688,6364,1313,6781,0
198,2.30569,3,0,100,0,176.524,3,8177,70,0,16,10,4.77568,6434,1323,6881,0
271,3.15576,61,0,4,0,98.803,61,8154,4,0,71,4,4.57766,6438,1327,6885,0
299,3.48182,75,0,10,0,150.33,75,8177,10,0,29,10,4.6359,6448,1337,6895,0
273,3.17899,83,0,100,0,145.475,2,8180,100,0,21,17,4.40294,6548,1354,6995,0
257,2.99267,73,0,0,0,146.786,74,8189,0,0,99,0,5.16006,6548,1354,6995,0
156,1.81661,8,0,83,0,157.673,8,8188,66,0,12,7,5.49786,6614,1361,7078,0
274,3.18999,59,0,63,0,104.985,2,8189,62,0,62,4,5.52115,6676,1365,7141,0
176,2.04957,30,0,0,0,95.649,30,8191,1,0,78,0,6.31322,6677,1365,7141,0
266,3.0971,34,0,3,0,97.57,34,8189,3,0,107,3,6.1152,6680,1368,7144,0
247,2.87643,36,0,5,0,97.405,36,8191,5,0,79,5,6.60442,6685,1373,7149,0
279,3.24901,57,0,5,0,103.031,57,8189,5,0,94,5,6.75584,6690,1378,7154,0
400,4.65784,90,0,5,0,170.457,101,8132,5,0,110,5,7.03539,6695,1383,7159,0
257,2.99272,106,0,23,0,172.056,106,8191,23,0,16,23,7.37318,6718,1406,7182,0
305,3.55169,55,0,111,0,101.423,55,8189,99,0,62,5,6.54618,6817,1411,7293,0
217,2.5269,3,0,78,0,151.04,3,8191,78,0,30,8,6.60442,6895,1419,7371,0
252,2.93382,36,0,2,0,106.056,36,8190,2,0,96,2,5.02029,6897,1421,7373,0
234,2.72496,19,0,40,0,65.202,19,8189,40,0,71,3,3.82054,6937,1424,7413,0
292,3.40029,25,0,2,0,77.83,25,8189,2,0,132,2,5.14842,6939,1426,7415,0
293,3.41212,30,0,2,0,84.31,30,8189,2,0,128,2,5.11347,6941,1428,7417,0
277,3.22558,33,0,5,0,90.75,33,8189,5,0,96,5,5.32314,6946,1433,7422,0
233,2.71341,18,0,37,0,61.196,18,8189,37,0,80,3,5.90554,6983,1436,7459,0
265,3.08602,23,0,3,0,60.725,23,8189,3,0,113,3,5.5095,6986,1439,7462,0
283,3.29518,28,0,2,0,65.445,28,8191,2,0,125,2,4.28646,6988,1441,7464,0
263,3.0627,31,0,3,0,86.767,31,8189,3,0,108,3,4.03021,6991,1444,7467,0
298,3.47001,35,0,6,0,92.364,35,8191,6,0,107,6,2.66739,6997,1450,7473,0
305,3.55166,37,0,45,0,83.825,2,8189,45,0,86,8,2.58586,7042,1458,7518,0
237,2.76,22,0,1,0,74.05,22,8191,1,0,117,1,2.52762,7043,1459,7519,0
241,2.80557,14,0,26,0,38.567,14,8189,26,0,87,2,2.79552,7069,1461,7545,0
264,3.07425,21,0,1,0,70.705,21,8190,1,0,133,1,3.61088,7070,1462,7546,0
172,2.00291,5,0,29,0,72.159,5,8191,29,0,56,3,4.03021,7099,1465,7575,0
209,2.43375,15,0,0,0,38.549,15,8191,0,0,108,0,4.46118,7099,1465,7575,0
264,3.07381,22,0,1,0,59.866,22,8189,1,0,126,1,4.90381,7100,1466,7576,0
220,2.56189,15,0,24,0,39.967,15,8189,24,0,100,1,6.45299,7124,1467,7600,0
250,2.91118,11,0,22,0,58.906,11,8189,22,0,108,2,5.34643,7146,1469,7622,0
265,3.08589,19,0,0,0,53.567,19,8189,0,0,137,0,4.88051,7146,1469,7622,0
270,3.14406,25,0,2,0,72.358,25,8189,2,0,121,2,4.19328,7148,1471,7624,0
260,3.02764,28,0,6,0,85.063,28,8189,6,0,96,6,3.52934,7154,1477,7630,0
305,3.55187,32,0,2,0,79.852,32,8189,2,0,127,2,4.40294,7156,1479,7632,0
129,1.50223,9,0,40,0,45.924,9,8191,40,0,47,2,5.49786,7196,1481,7672,0
250,2.91109,18,0,0,0,62.001,18,8190,0,0,129,0,5.90554,7196,1481,7672,0
279,3.24889,24,0,1,0,84.29,24,8189,1,0,133,1,7.36154,7197,1482,7673,0
290,3.37701,4,0,32,0,76.722,3,8167,32,0,111,4,6.6976,7229,1486,7705,0
226,2.63186,19,0,1,0,54.103,19,8191,1,0,101,1,3.7856,7230,1487,7706,0
230,2.67848,24,0,0,0,98.954,24,8191,0,0,118,0,3.59923,7230,1487,7706,0
294,3.42355,28,0,3,0,75.39,28,8191,3,0,112,3,4.46118,7233,1490,7709,0
229,2.66578,18,0,31,0,65.535,18,8191,31,0,101,2,4.88051,7264,1492,7740,0
278,3.23724,24,0,2,0,70.392,24,8189,2,0,123,2,6.02202,7266,1494,7742,0
304,3.53996,30,0,0,0,89.37,30,8191,0,0,156,0,6.20838,7266,1494,7742,0
246,2.86476,16,0,34,0,70.877,16,8191,34,0,78,3,6.17344,7300,1497,7776,0
274,3.19065,22,0,1,0,75.216,22,8191,1,0,134,1,5.57939,7301,1498,7777,0
281,3.27245,27,0,3,0,74.416,27,8189,3,0,126,3,5.48621,7304,1501,7780,0
248,2.88812,30,0,4,0,96.953,30,8189,4,0,88,4,6.02202,7308,1505,7784,0
241,2.80648,16,0,36,0,55.321,16,8189,36,0,70,4,5.70752,7344,1509,7820,0
248,2.8879,23,0,0,0,61.96,23,8189,0,0,126,0,6.01037,7344,1509,7820,0
223,2.59688,7,0,28,0,86.385,7,8189,28,0,89,2,5.90554,7372,1511,7848,0
264,3.07426,20,0,0,0,71.736,20,8189,0,0,131,0,6.22003,7372,1511,7848,0
286,3.33012,25,0,3,0,77.25,25,8189,3,0,125,3,5.69587,7375,1514,7851,0
167,1.94468,7,0,32,0,51.896,7,8189,32,0,57,2,5.71917,7407,1516,7883,0
236,2.74819,17,0,0,0,61.033,17,8191,0,0,123,0,4.57766,7407,1516,7883,0
239,2.78309,23,0,1,0,64.64,23,8191,1,0,112,1,4.69414,7408,1517,7884,0
296,3.44695,27,0,4,0,77.114,27,8189,4,0,119,4,5.56774,7412,1521,7888,0
277,3.22468,31,0,4,0,85.72,31,8189,4,0,103,4,6.94221,7416,1525,7892,0
264,3.07431,33,0,4,0,88.382,33,8189,4,0,91,4,6.06861,7420,1529,7896,0
350,4.07554,37,0,6,0,95.471,37,8155,6,0,110,6,5.94048,7426,1535,7902,0
275,3.20235,21,0,39,0,52.652,21,8189,39,0,108,2,6.6976,7465,1537,7941,0
293,3.41211,27,0,1,0,77.554,27,8189,1,0,138,1,7.44307,7466,1538,7942,0
264,3.07433,30,0,4,0,90.602,30,8189,4,0,109,4,8.04877,7470,1542,7946,0
290,3.37701,34,0,6,0,85.204,34,8191,6,0,105,6,6.41805,7476,1548,7952,0
251,2.92285,18,0,39,0,46.519,18,8189,39,0,86,4,5.75411,7515,1552,7991,0
218,2.53856,3,0,24,0,77.798,3,8169,24,0,94,2,5.16006,7539,1554,8015,0
249,2.89956,18,0,0,0,47.823,18,8189,0,0,125,0,4.12339,7539,1554,8015,0
290,3.37695,24,0,2,0,65.044,24,8189,2,0,129,2,4.30976,7541,1556,8017,0
288,3.35343,28,0,3,0,73.454,28,8191,3,0,113,3,5.17171,7544,1559,8020,0
261,3.03927,31,0,3,0,84.13,31,8189,3,0,91,3,5.5095,7547,1562,8023,0
267,3.10917,34,0,8,0,98.094,34,8190,8,0,91,8,5.5328,7555,1570,8031,0
294,3.42359,37,0,5,0,95.096,37,8191,5,0,101,5,4.55437,7560,1575,8036,0
305,3.55165,69,0,8,0,130.415,69,8182,8,0,71,8,4.11174,7568,1583,8044,0
359,4.1806,77,0,19,0,113.902,79,8189,19,0,24,19,3.55264,7587,1602,8063,0
324,3.7728,107,0,16,0,153.433,107,8191,16,0,83,16,4.22822,7603,1618,8079,0
266,3.09771,116,0,25,0,189.121,116,8191,25,0,30,25,4.69414,7628,1643,8104,0
204,2.37572,33,0,117,0,88.057,33,8189,117,0,31,1,5.20666,7745,1644,8221,0
279,3.24895,29,0,65,0,70.923,29,8189,65,0,70,7,5.64928,7810,1651,8286,0
289,3.36535,32,0,4,0,91.106,32,8191,4,0,106,4,5.71917,7814,1655,8290,0
232,2.70082,18,0,36,0,63.887,18,8191,36,0,78,2,5.83565,7850,1657,8326,0
271,3.15595,22,0,1,0,66.115,24,8190,1,0,133,1,5.07853,7851,1658,8327,0
293,3.41188,6,0,32,0,77.021,3,8169,32,0,122,4,4.82227,7883,1662,8359,0
231,2.68996,19,0,1,0,54.595,19,8189,1,0,104,1,4.61261,7884,1663,8360,0
299,3.48064,25,0,2,0,67.919,25,8166,2,0,130,2,5.06688,7886,1665,8362,0
255,2.96843,17,0,27,0,49.024,17,8191,27,0,115,1,6.19674,7913,1666,8389,0
255,2.96939,23,0,2,0,73.906,23,8189,2,0,113,2,5.70752,7915,1668,8391,0
265,3.08599,27,0,2,0,68.27,27,8189,2,0,116,2,5.85894,7917,1670,8393,0
256,2.98122,31,0,3,0,104.438,31,8189,3,0,106,3,6.05696,7920,1673,8396,0
238,2.77162,16,0,34,0,49.203,16,8189,34,0,100,1,6.16179,7954,1674,8430,0
269,3.13263,22,0,2,0,61.512,22,8189,2,0,119,2,7.12858,7956,1676,8432,0
254,2.95782,27,0,2,0,81.656,27,8190,2,0,118,2,7.60614,7958,1678,8434,0
277,3.22558,16,0,30,0,47.625,16,8189,30,0,111,1,7.87405,7988,1679,8464,0
245,2.85316,11,0,20,0,35.726,13,8189,20,0,112,1,7.19846,8008,1680,8484,0
260,3.02758,20,0,1,0,63.266,20,8191,1,0,125,1,5.73082,8009,1681,8485,0
290,3.37706,26,0,2,0,76.031,26,8189,2,0,128,2,4.78733,8011,1683,8487,0
286,3.33043,29,0,4,0,71.762,29,8189,4,0,100,4,4.6592,8015,1687,8491,0
201,2.34037,18,0,30,0,64.081,18,8189,30,0,82,1,4.99699,8045,1688,8521,0
277,3.22558,24,0,0,0,72.013,24,8191,0,0,145,0,5.76576,8045,1688,8521,0
136,1.58369,14,0,26,0,88.096,14,8189,26,0,54,1,6.03366,8071,1689,8547,0
279,3.24905,22,0,1,0,69.679,22,8191,1,0,132,1,6.24333,8072,1690,8548,0
283,3.29547,27,0,1,0,78.34,27,8191,1,0,145,1,7.43142,8073,1691,8549,0
279,3.24885,30,0,4,0,82.172,30,8189,4,0,89,4,6.88397,8077,1695,8553,0
261,3.03945,33,0,4,0,92.874,33,8189,4,0,89,4,7.05869,8081,1699,8557,0
243,2.82989,36,0,2,0,98.121,36,8189,2,0,95,2,5.89389,8083,1701,8559,0
328,3.81951,73,0,6,0,141.021,73,8191,6,0,121,6,5.09018,8089,1707,8565,0
179,2.08442,36,0,75,0,69.223,36,8191,60,0,47,2,5.40467,8149,1709,8640,0
231,2.68997,14,0,41,0,78.51,14,8189,41,0,51,4,5.5561,8190,1713,8681,0
267,3.10915,23,0,2,0,66.266,23,8189,2,0,118,2,7.12858,8192,1715,8683,0
214,2.49199,3,0,31,0,71.027,3,8190,31,0,86,2,6.39475,8223,1717,8714,0
149,1.73506,12,0,0,0,43.338,12,8189,0,0,76,0,6.08026,8223,1717,8714,0
252,2.93449,20,0,0,0,59.331,20,8189,0,0,131,0,4.81062,8223,1717,8714,0
264,3.07444,26,0,1,0,79.149,26,8189,1,0,136,1,4.29811,8224,1718,8715,0
255,2.96944,29,0,4,0,85.21,29,8191,4,0,86,4,3.98362,8228,1722,8719,0
283,3.29474,32,0,5,0,89.108,32,8189,5,0,99,5,4.3913,8233,1727,8724,0
260,3.02767,35,0,5,0,112.84,35,8191,5,0,103,5,5.2183,8238,1732,8729,0
266,3.09653,38,0,9,0,121.761,38,8189,9,0,83,9,3.55264,8247,1741,8738,0
297,3.4584,71,0,10,0,133.907,71,8177,10,0,56,10,3.35462,8257,1751,8748,0
234,2.7247,35,0,77,0,71.627,35,8189,77,0,40,6,3.56429,8334,1757,8825,0
215,2.50365,18,0,39,0,59.898,18,8189,39,0,69,3,3.28474,8373,1760,8864,0
211,2.45706,14,0,20,0,53.714,14,8191,20,0,96,1,3.87878,8393,1761,8884,0
286,3.33043,22,0,1,0,68.499,22,8191,1,0,143,1,3.97197,8394,1762,8885,0
298,3.47012,27,0,2,0,72.652,27,8189,2,0,121,2,3.92538,8396,1764,8887,0
260,3.02767,30,0,5,0,78.818,30,8161,5,0,81,5,4.18163,8401,1769,8892,0
290,3.37731,33,0,5,0,88.261,33,8189,5,0,95,5,3.79725,8406,1774,8897,0
221,2.57352,19,0,34,0,71.015,19,8191,34,0,90,1,5.05523,8440,1775,8931,0
264,3.07331,15,0,23,0,37.351,15,8191,3,0,133,1,5.89389,8443,1776,8954,0
281,3.27239,22,0,1,0,62.674,22,8190,1,0,134,1,5.95213,8444,1777,8955,0
265,3.086,27,0,3,0,86.267,27,8166,3,0,115,3,5.89389,8447,1780,8958,0
231,2.68992,29,0,4,0,101.138,29,8172,4,0,81,4,5.81235,8451,1784,8962,0
198,2.30588,6,0,37,0,58.418,6,8189,37,0,71,2,5.64928,8488,1786,8999,0
160,1.86334,12,0,8,0,44.703,12,8189,8,0,79,0,5.46291,8496,1786,9007,0
277,3.22585,20,0,0,0,55.561,20,8189,0,0,144,0,4.3447,8496,1786,9007,0
250,2.91122,25,0,1,0,80.747,25,8189,1,0,120,1,4.15834,8497,1787,9008,0
271,3.15572,30,0,3,0,87.336,30,8190,3,0,117,3,4.03021,8500,1790,9011,0
207,2.41054,19,0,31,0,58.637,19,8189,31,0,84,1,4.03021,8531,1791,9042,0
287,3.34229,25,0,1,0,79.672,25,8191,1,0,137,1,3.98362,8532,1792,9043,0
235,2.73657,16,0,28,0,45.67,16,8191,28,0,92,2,4.54272,8560,1794,9071,0
281,3.2722,23,0,1,0,70.653,23,8191,1,0,136,1,5.43962,8561,1795,9072,0
255,2.96941,27,0,3,0,108.53,27,8189,3,0,109,3,5.40467,8564,1798,9075,0
260,3.02656,30,0,3,0,81.133,30,8191,3,0,96,3,6.56947,8567,1801,9078,0
310,3.61005,3,0,38,0,85.156,3,8160,38,0,113,4,6.94221,8605,1805,9116,0
233,2.71275,22,0,1,0,60.205,22,8190,1,0,114,1,7.75757,8606,1806,9117,0
283,3.29496,27,0,2,0,68.904,27,8191,2,0,126,2,7.2567,8608,1808,9119,0
265,3.08411,12,0,32,0,48.657,15,8191,32,0,93,3,5.96378,8640,1811,9151,0
283,3.29537,22,0,2,0,60.011,22,8190,2,0,134,2,4.6825,8642,1813,9153,0
259,3.01616,26,0,2,0,83.141,26,8189,2,0,110,2,3.55264,8644,1815,9155,0
281,3.27236,30,0,4,0,86.196,30,8189,4,0,91,4,2.98189,8648,1819,9159,0
248,2.88779,33,0,4,0,95.356,33,8191,4,0,96,4,3.77395,8652,1823,9163,0
221,2.57353,7,0,37,0,95.555,7,8189,37,0,50,3,3.94867,8689,1826,9200,0
271,3.15572,22,0,1,0,59.893,22,8189,1,0,125,1,3.8089,8690,1827,9201,0
241,2.8063,14,0,26,0,37.958,14,8191,26,0,106,1,4.64755,8716,1828,9227,0
237,2.7598,12,0,18,0,55.286,12,8189,18,0,120,0,4.74074,8734,1828,9245,0
250,2.91121,20,0,1,0,56.241,20,8190,1,0,128,1,5.00864,8735,1829,9246,0
257,2.99274,17,0,21,0,48.172,17,8189,21,0,108,1,5.35808,8756,1830,9267,0
207,2.41044,14,0,19,0,40.594,14,8189,19,0,94,1,5.87059,8775,1831,9286,0
243,2.82996,21,0,1,0,63.892,21,8189,1,0,119,1,5.88224,8776,1832,9287,0
296,3.447,26,0,28,0,81.003,2,8191,28,0,128,2,4.15834,8804,1834,9315,0
228,2.65509,19,0,0,0,60.04,19,8189,0,0,114,0,3.8089,8804,1834,9315,0
268,3.12082,24,0,3,0,77.084,24,8191,3,0,121,3,4.40294,8807,1837,9318,0
158,1.83992,12,0,26,0,82.362,13,8190,26,0,53,1,4.14669,8833,1838,9344,0
270,3.14404,21,0,1,0,56.186,21,8191,1,0,129,1,4.81062,8834,1839,9345,0
262,3.05104,26,0,1,0,83.453,26,8189,1,0,135,1,4.51942,8835,1840,9346,0
290,3.377,30,0,3,0,85.475,30,8189,3,0,111,3,4.04186,8838,1843,9349,0
284,3.30724,34,0,5,0,93.062,34,8189,5,0,113,5,3.62253,8843,1848,9354,0
256,2.98112,21,0,35,0,73.664,21,8191,35,0,108,1,4.29811,8878,1849,9389,0
269,3.13247,3,0,29,0,72.733,3,8166,29,0,105,3,4.41459,8907,1852,9418,0
245,2.85301,19,0,0,0,64.631,19,8189,0,0,125,0,5.03194,8907,1852,9418,0
276,3.21342,24,0,1,0,65.766,25,8191,1,0,136,1,5.68422,8908,1853,9419,0
213,2.47993,12,0,29,0,59.005,15,8191,29,0,79,2,4.67085,8937,1855,9448,0
268,3.1208,3,0,22,0,63.01,3,8191,22,0,127,1,4.26317,8959,1856,9470,0
254,2.95797,18,0,0,0,49.111,18,8191,0,0,125,0,4.42624,8959,1856,9470,0
297,3.45875,25,0,1,0,56.582,25,8189,1,0,151,1,4.368,8960,1857,9471,0


