SendPacket,SendRate(Mb/s),FlightSize,ReceiveRate(Mb/s),Send Loss,Recv Loss,RTT(ms),CWnd,FlowWindow,Retrans,PktSndPeriod(us),RecvACK,RecvNAK,EstimatedBandwidth(Mb/s),Retrans_Total,NAK_TotalRecv,Total Send Loss,Total Recv Loss,Timeout,usSndDuration
157,1.69801,12,0,1,0,35.092,12,8189,1,0,80,0,11.7878,1,0,1,0,1,-421886904335467
400,4.65781,23,0,0,0,41.066,23,8189,0,0,203,0,13.0924,1,0,1,0,1,2790373018
517,6.0206,33,0,0,0,35.034,33,8189,0,0,259,0,13.8495,1,0,1,0,1,2765588398
529,6.16009,64,0,1,0,75.892,69,8189,1,0,230,1,11.2869,2,1,2,0,1,2772746318
589,6.85843,68,0,2,0,109.561,142,8189,2,0,239,2,15.1308,4,3,4,0,1,2833216866
640,7.45268,131,0,9,0,101.073,159,8161,9,0,80,9,19.755,13,12,13,0,1,2742005721
725,8.44309,65,0,27,0,92.008,177,8189,27,0,95,26,12.6148,40,38,40,0,1,2866195197
629,7.32457,189,0,18,0,133.445,189,8181,18,0,72,18,12.0324,58,56,58,0,1,2526315666
0,0,189,0,0,0,133.445,189,8181,0,0,0,0,12.0324,58,56,58,0,1,0
480,5.58956,88,0,191,0,77.215,88,8189,67,0,135,2,15.2938,125,58,249,0,2,5668270848
667,7.76747,94,0,5,0,127.272,130,8191,5,0,142,5,19.3939,130,63,254,0,2,2960901996
695,8.0931,62,0,7,0,82.299,165,8189,7,0,165,7,16.645,137,70,261,0,2,2776408000
696,8.10512,84,0,13,0,98.675,186,8189,13,0,114,13,18.4388,150,83,274,0,2,2830155290
260,3.02767,190,0,19,0,104.719,190,8180,19,0,25,19,18.6717,169,102,293,0,2,821193378
227,2.64329,55,0,190,0,53.012,55,8189,58,0,62,0,17.041,227,102,483,0,3,4750440826
588,6.84661,112,0,7,0,92.82,114,8189,7,0,154,7,14.793,234,109,490,0,3,2700799906
316,3.67959,125,0,19,0,156.112,125,8180,19,0,42,19,14.4785,253,128,509,0,3,1668070578
89,1.03643,12,0,126,0,112.956,12,8189,60,0,10,1,14.6182,313,129,635,0,4,3991724787
670,7.80228,75,0,2,0,128.651,120,8137,2,0,228,2,14.9444,315,131,637,0,4,2811140045
651,7.58129,122,0,3,0,109.275,162,8189,3,0,189,3,22.3525,318,134,640,0,4,2681633906
597,6.95226,95,0,20,0,113.364,178,8165,18,0,84,19,19.324,336,153,660,0,4,2803546168
91,1.05979,178,0,5,0,112.959,178,8190,7,0,1,5,19.2076,343,158,665,0,4,224218110
355,4.13378,57,0,179,0,72.815,64,8191,90,0,79,1,16.5984,433,159,844,0,5,5450215680
663,7.72116,74,0,4,0,108.999,130,8189,4,0,200,4,16.5052,437,163,848,0,5,2828489141
602,7.01023,135,0,11,0,109.923,149,8150,11,0,83,11,17.4487,448,174,859,0,5,2366527826
756,8.80325,180,0,9,0,158.765,180,8140,9,0,162,9,19.2658,457,183,868,0,5,3192399935
584,6.80066,192,0,2,0,231.585,203,8189,2,0,134,2,19.4988,459,185,870,0,5,2770355682
138,1.60702,207,0,6,0,227.893,207,8122,6,0,26,6,19.6618,465,191,876,0,5,483457366
325,3.78454,73,0,207,0,90.09,73,8189,66,0,98,0,21.0945,531,191,1083,0,6,5154823459
670,7.80184,80,0,1,0,176.837,150,8191,1,0,267,1,17.4021,532,192,1084,0,6,2770081683
579,6.74216,99,0,11,0,144.372,174,8190,11,0,124,11,14.4319,543,203,1095,0,6,2666576106
276,3.21398,176,0,20,0,141.169,176,8191,20,0,9,20,14.4202,563,223,1115,0,6,1228072128
185,2.15433,7,0,176,0,135.347,7,8189,175,0,5,0,13.8262,738,223,1291,0,7,4458891828
571,6.64933,75,0,5,0,130.468,97,8130,5,0,156,5,14.7813,743,228,1296,0,7,2758700161
650,7.56902,126,0,7,0,111.238,144,8191,7,0,176,7,15.8646,750,235,1303,0,7,2851456661
578,6.73084,149,0,12,0,129.151,149,8191,12,0,26,12,17.5885,762,247,1315,0,7,2473950972
662,7.7096,99,0,9,0,176.092,176,8147,8,0,136,9,17.0643,770,256,1324,0,7,2947817852
557,6.48673,183,0,31,0,113.184,183,8191,32,0,39,31,13.6515,802,287,1355,0,7,2200418052
89,1.03641,183,0,183,0,113.184,2,8191,89,0,0,0,13.6515,891,287,1538,0,8,0
529,6.15998,88,0,2,0,94.858,97,8189,4,0,160,2,13.1506,895,289,1540,0,8,6388080020
509,5.92678,93,0,7,0,163.738,120,8106,7,0,79,7,15.2356,902,296,1547,0,8,2684295715
669,7.79067,118,0,9,0,133.397,155,8190,9,0,153,9,12.9759,911,305,1556,0,8,2832585313
682,7.94204,94,0,15,0,111.551,175,8189,15,0,102,15,12.6847,926,320,1571,0,8,2792844158
710,8.26768,95,0,9,0,101.217,191,8130,9,0,94,9,16.7382,935,329,1580,0,8,2713140472
686,7.98844,89,0,9,0,126.805,210,8189,9,0,115,9,15.6549,944,338,1589,0,8,2833841540
122,1.42072,210,0,1,0,126.805,210,8189,1,0,0,1,15.6549,945,339,1590,0,8,0
406,4.72746,68,0,211,0,100.421,78,8191,59,0,110,1,12.51,1004,340,1801,0,9,5672461229
688,8.01251,138,0,2,0,146.052,140,8189,2,0,213,2,18.2757,1006,342,1803,0,9,2829629023
662,7.70944,87,0,3,0,133.64,177,8189,3,0,182,3,20.3491,1009,345,1806,0,9,2605418078
745,8.67543,143,0,8,0,154.59,211,8191,8,0,209,8,17.4953,1017,353,1814,0,9,2975699384
703,8.18628,93,0,22,0,106.283,217,8175,22,0,36,22,14.6998,1039,375,1836,0,9,2776890179
601,6.99878,202,0,53,0,112.844,222,8187,53,0,35,49,11.9974,1092,424,1889,0,9,2431058837
28,0.326076,222,0,8,0,112.844,222,8187,8,0,0,8,11.9974,1100,432,1897,0,9,0
437,5.0892,78,0,222,0,82.324,78,8189,155,0,109,0,8.16525,1255,432,2119,0,10,5973736824
568,6.61465,89,0,7,0,107.02,123,8187,7,0,144,7,10.8792,1262,439,2126,0,10,2726445827
643,7.4876,91,0,13,0,121.422,145,8189,13,0,92,13,16.6799,1275,452,2139,0,10,2847344315
142,1.6536,150,0,12,0,121.442,150,8191,12,0,21,12,16.9129,1287,464,2151,0,10,510220077
226,2.6318,55,0,150,0,103.164,55,8189,59,0,61,0,16.0044,1346,464,2301,0,11,5094290049
541,6.29987,71,0,3,0,109.671,125,8189,3,0,197,3,15.8063,1349,467,2304,0,11,2700313170
699,8.14019,127,0,15,0,104.378,145,8165,15,0,87,15,13.5583,1364,482,2319,0,11,2864261335
645,7.51163,154,0,16,0,100.672,154,8157,16,0,41,16,12.2304,1380,498,2335,0,11,2563151023
3,0.0349356,154,0,3,0,100.672,154,8157,3,0,0,3,12.2304,1383,501,2338,0,11,0
418,4.86782,60,0,155,0,103.821,82,8190,63,0,119,1,14.6299,1446,502,2493,0,12,5844314972
542,6.31149,112,0,6,0,114.146,115,8189,6,0,103,6,14.2688,1452,508,2499,0,12,2777037224
654,7.61607,158,0,6,0,111.222,158,8189,6,0,183,6,15.9228,1458,514,2505,0,12,2289182994
681,7.931,129,0,8,0,122.961,177,8143,8,0,98,8,15.2356,1466,522,2513,0,12,3267982502
640,7.45304,203,0,4,0,132.212,203,8191,4,0,154,4,14.5716,1470,526,2517,0,12,2537349466
1038,12.0883,249,0,0,0,270.32,260,8189,0,0,418,0,25.8353,1470,526,2517,0,12,3061998715
614,7.15001,82,0,6,0,94.926,290,8189,6,0,256,6,20.2559,1476,532,2523,0,12,2816919315
237,2.75997,291,0,15,0,87.637,291,8191,15,0,7,15,19.324,1491,547,2538,0,12,125334508
333,3.87792,46,0,291,0,39.531,46,8189,199,0,47,0,13.2671,1690,547,2829,0,13,5473859228
622,7.24324,111,0,5,0,120.556,111,8191,5,0,160,5,16.5402,1695,552,2834,0,13,2766597182
639,7.4412,149,0,6,0,155.59,149,8189,6,0,156,6,15.5268,1701,558,2840,0,13,2677110210
654,7.61555,90,0,5,0,179.432,174,8189,5,0,123,5,13.8844,1706,563,2845,0,13,2847275532
423,4.92569,178,0,16,0,148.101,178,8171,16,0,26,16,12.3469,1722,579,2861,0,13,1778090502
79,0.919977,3,0,178,0,144.271,3,8013,76,0,1,0,12.2071,1798,579,3039,0,14,3624869249
353,4.11077,56,0,1,0,86.728,84,8189,1,0,123,1,11.3219,1799,580,3040,0,14,3065655015
602,7.00988,124,0,6,0,162.248,131,8166,6,0,159,6,14.8279,1805,586,3046,0,14,2577241476
553,6.43994,154,0,8,0,117.578,154,8190,8,0,102,8,16.843,1813,594,3054,0,14,2668752978
629,7.32533,88,0,7,0,174.239,178,8191,7,0,123,7,15.6316,1820,601,3061,0,14,3099419038
265,3.08579,179,0,13,0,137.888,179,8168,13,0,6,13,15.2938,1833,614,3074,0,14,946265183
76,0.885039,6,0,180,0,118.411,6,8189,64,0,4,1,15.1773,1897,615,3254,0,15,4612561669
156,1.81676,52,0,5,0,131.676,52,8183,5,0,52,5,13.6282,1902,620,3259,0,15,2137503886
101,1.17615,19,0,52,0,81.562,19,8187,52,0,17,0,13.4884,1954,620,3311,0,16,3524895906
524,6.10162,34,0,0,0,66.556,34,8189,0,0,259,0,11.7528,1954,620,3311,0,16,2787157212
578,6.73059,89,0,1,0,64.218,90,8189,1,0,238,1,14.56,1955,621,3312,0,16,2788684108
675,7.86024,134,0,4,0,93.425,149,8189,4,0,221,4,12.1838,1959,625,3316,0,16,2792280687
782,9.10646,60,0,5,0,73.221,197,8189,5,0,256,5,15.6666,1964,630,3321,0,16,2789428009
786,9.15244,225,0,4,0,160.074,225,8189,4,0,189,4,17.9729,1968,634,3325,0,16,2604770461
702,8.17454,101,0,8,0,124.879,242,8154,7,0,123,8,15.7015,1975,642,3333,0,16,2954784589
753,8.76904,183,0,11,0,123.241,253,8189,12,0,85,11,14.2339,1987,653,3344,0,16,2495118645
769,8.95519,125,0,8,0,130.135,271,8164,8,0,146,8,12.5682,1995,661,3352,0,16,3021500289
152,1.77002,271,0,6,0,130.135,271,8164,6,0,0,6,12.5682,2001,667,3358,0,16,0
231,2.6901,22,0,271,0,97.598,22,8189,176,0,20,0,14.1873,2177,667,3629,0,17,5705008824
469,5.46142,109,0,0,0,162.515,114,8189,0,0,196,0,16.9129,2177,667,3629,0,17,2694618616
575,6.69606,81,0,8,0,122.39,141,8191,8,0,108,8,16.1208,2185,675,3637,0,17,2830113938
363,4.22758,152,0,8,0,155.27,152,8133,8,0,53,8,14.793,2193,683,3645,0,17,1425721262
106,1.23444,7,0,152,0,137.889,7,8189,92,0,5,0,14.8628,2285,683,3797,0,18,4163626936
467,5.43872,97,0,4,0,121.472,97,8189,4,0,157,4,13.7563,2289,687,3801,0,18,2617448619
610,7.10414,106,0,7,0,138.103,125,8147,7,0,97,7,14.4319,2296,694,3808,0,18,2893628253
674,7.84864,122,0,9,0,95.241,156,8167,9,0,134,9,17.8797,2305,703,3817,0,18,2821633206
175,2.03786,157,0,13,0,99.57,157,8183,13,0,6,12,17.0527,2318,715,3830,0,18,735940688
303,3.52847,63,0,157,0,79.879,65,8189,87,0,81,0,12.4634,2405,715,3987,0,19,4852163302
651,7.58093,102,0,6,0,119.589,127,8191,6,0,184,6,11.9508,2411,721,3993,0,19,2807300876
665,7.7444,143,0,11,0,145.213,161,8189,11,0,156,11,15.5035,2422,732,4004,0,19,2886939609
714,8.31455,120,0,13,0,88.582,190,8190,12,0,161,13,14.2688,2434,745,4017,0,19,2799490539
835,9.7238,176,0,11,0,188.394,217,8191,12,0,171,11,12.9992,2446,756,4028,0,19,2771735986
818,9.52514,218,0,10,0,91.783,236,8191,10,0,134,10,14.7464,2456,766,4038,0,19,2772818604
727,8.46567,262,0,3,0,195.287,265,8189,3,0,226,3,15.4569,2459,769,4041,0,19,2837233097
791,9.21118,86,0,2,0,264.261,305,8187,2,0,358,2,20.8499,2461,771,4043,0,19,2797482511
833,9.69984,313,0,24,0,99.522,313,8169,24,0,78,24,15.9927,2485,795,4067,0,19,2756726350
474,5.51997,320,0,26,0,126.336,320,8186,26,0,73,26,15.4103,2511,821,4093,0,19,1109721344
147,1.71195,5,0,320,0,130.175,5,8101,142,0,3,0,15.189,2653,821,4413,0,20,4330761592
178,2.07293,59,0,0,0,194.307,59,8189,0,0,65,0,18.6834,2653,821,4413,0,20,2971011442
531,6.18398,135,0,0,0,190.248,135,8189,0,0,232,0,18.695,2653,821,4413,0,20,2792419602
620,7.22034,154,0,6,0,212.727,172,8189,6,0,180,6,17.2856,2659,827,4419,0,20,2784527148
627,7.30135,101,0,4,0,213.263,199,8191,4,0,156,4,15.783,2663,831,4423,0,20,2658309552
671,7.81362,123,0,39,0,113.691,211,8177,39,0,74,38,15.0609,2702,869,4462,0,20,2855502622
801,9.32731,193,0,29,0,145.722,231,8179,29,0,140,28,12.6148,2731,897,4491,0,20,2752493454
730,8.50099,112,0,11,0,121.223,244,8191,11,0,100,11,17.4953,2742,908,4502,0,20,2874958548
704,8.19854,91,0,8,0,127.622,255,8191,8,0,86,8,17.6584,2750,916,4510,0,20,2790095720
736,8.57106,131,0,17,0,115.426,265,8180,17,0,75,17,12.0906,2767,933,4527,0,20,2835614121
231,2.69005,265,0,12,0,126.784,265,8174,12,0,4,11,11.415,2779,944,4539,0,20,357592725
243,2.82971,35,0,265,0,73.902,35,8189,153,0,33,0,11.45,2932,944,4804,0,21,5236867990
590,6.87071,92,0,4,0,125.747,111,8189,4,0,174,4,14.0591,2936,948,4808,0,21,2696228714
660,7.68556,103,0,19,0,90.638,125,8191,19,0,51,19,14.758,2955,967,4827,0,21,2846979330
151,1.75839,131,0,6,0,77.831,131,8178,6,0,24,6,14.8046,2961,973,4833,0,21,612579772
321,3.73811,58,0,132,0,82.706,63,8129,59,0,76,1,15.2356,3020,974,4965,0,22,4994750586
585,6.81238,119,0,0,0,196.66,145,8189,0,0,267,0,20.9431,3020,974,4965,0,22,2818427898
641,7.46403,64,0,8,0,85.293,180,8190,8,0,177,8,13.1972,3028,982,4973,0,22,2720213854
184,2.14274,180,0,7,0,89.096,180,8191,7,0,3,7,13.1739,3035,989,4980,0,22,381310594
160,1.86325,37,0,180,0,75.744,37,8189,58,0,35,0,11.252,3093,989,5160,0,23,5275714340
606,7.05698,84,0,4,0,127.312,116,8191,4,0,191,4,10.9142,3097,993,5164,0,23,2736291886
587,6.83574,105,0,6,0,165.123,144,8177,6,0,111,6,12.4517,3103,999,5170,0,23,2793760444
391,4.55311,79,0,6,0,220.506,170,8191,6,0,130,6,15.2123,3109,1005,5176,0,23,2771508029
819,9.53739,158,0,21,0,100.899,187,8191,21,0,97,21,14.2455,3130,1026,5197,0,23,2716293985
711,8.28006,71,0,7,0,105.376,211,8191,6,0,147,7,19.5803,3136,1033,5204,0,23,2963894864
687,8.00019,135,0,9,0,157.213,220,8153,10,0,62,9,18.6601,3146,1042,5213,0,23,2592401580
684,7.96498,96,0,11,0,95.44,238,8141,11,0,127,11,16.1325,3157,1053,5224,0,23,2929352532
745,8.67576,148,0,9,0,66.871,255,8189,9,0,129,9,16.9129,3166,1062,5233,0,23,2857808890
670,7.80227,122,0,15,0,135.124,271,8170,14,0,138,15,18.8581,3180,1077,5248,0,23,2778813534
617,7.18497,275,0,41,0,104.111,275,8172,42,0,28,39,19.5337,3222,1116,5289,0,23,1752925020
58,0.675383,275,0,275,0,104.111,2,8172,58,0,0,0,19.5337,3280,1116,5564,0,24,0
426,4.96085,78,0,3,0,94.302,78,8185,82,0,110,3,14.9793,3362,1119,5567,0,24,6562538444
250,2.91137,98,0,11,0,190.738,98,8184,11,0,56,7,15.8296,3373,1126,5578,0,24,1996240668
93,1.08295,13,0,98,0,167.628,13,8189,61,0,11,0,14.56,3434,1126,5676,0,25,3654524676
479,5.57775,64,0,9,0,86.149,82,8191,9,0,108,9,11.3219,3443,1135,5685,0,25,2582872572
715,8.32614,83,0,9,0,117.061,136,8161,9,0,184,9,9.88915,3452,1144,5694,0,25,2961505148
738,8.59406,93,0,3,0,106.866,179,8191,3,0,214,3,14.3853,3455,1147,5697,0,25,2835853060
720,8.38543,93,0,13,0,88.803,198,8189,13,0,109,13,13.0108,3468,1160,5710,0,25,2815233430
268,3.1208,203,0,9,0,113.585,203,8191,9,0,32,9,12.5915,3477,1169,5719,0,25,604496732
284,3.30724,37,0,204,0,46.11,37,8189,183,0,35,1,12.51,3660,1170,5923,0,26,4945212365
618,7.19625,89,0,2,0,72.69,121,8189,2,0,208,2,14.8396,3662,1172,5925,0,26,2675367012
645,7.51101,102,0,13,0,132.786,142,8191,13,0,88,13,16.6799,3675,1185,5938,0,26,2867075707
627,7.30123,155,0,31,0,95.072,155,8191,31,0,61,31,14.7347,3706,1216,5969,0,26,2357811090
0,0,155,0,0,0,95.072,155,8191,0,0,0,0,14.7347,3706,1216,5969,0,26,0
520,6.0553,60,0,159,0,128.235,98,8189,63,0,164,4,13.3836,3769,1220,6128,0,27,6049977716
597,6.95165,126,0,9,0,124.252,126,8189,9,0,99,9,14.793,3778,1229,6137,0,27,2859729984
617,7.18485,154,0,8,0,151.195,172,8189,8,0,217,8,17.9962,3786,1237,6145,0,27,2672952142
232,2.70156,175,0,10,0,183.654,175,8161,10,0,13,10,18.0544,3796,1247,6155,0,27,957857614
184,2.14261,35,0,175,0,55.448,35,8189,89,0,33,0,16.5751,3885,1247,6330,0,28,4690809308
562,6.54519,113,0,4,0,122.104,113,8136,4,0,181,4,16.2956,3889,1251,6334,0,28,2512648114
664,7.73278,100,0,6,0,114.804,155,8189,6,0,175,6,14.5134,3895,1257,6340,0,28,3148972554
584,6.80103,116,0,11,0,118.811,166,8147,11,0,55,11,13.9077,3906,1268,6351,0,28,2634458488
107,1.24593,166,0,7,0,115.108,166,8163,7,0,2,7,14.362,3913,1275,6358,0,28,332054558
166,1.93302,68,0,166,0,113.844,4,8128,166,0,2,0,14.2688,4079,1275,6524,0,29,3467688622
317,3.6916,36,0,68,0,52.461,36,8191,68,0,112,0,16.0859,4147,1275,6592,0,30,4657716442
603,7.02197,89,0,4,0,85.754,95,8191,4,0,182,4,15.4802,4151,1279,6596,0,30,2792095978
613,7.13823,131,0,4,0,121.998,139,8189,4,0,165,4,17.1459,4155,1283,6600,0,30,2811672132
632,7.35976,71,0,3,0,206.153,183,8189,3,0,218,3,20.4073,4158,1286,6603,0,30,2857073420
702,8.17468,75,0,25,0,101.567,194,8191,25,0,67,25,15.7597,4183,1311,6628,0,30,2785106916
675,7.86081,70,0,9,0,143.585,221,8127,9,0,174,9,14.1057,4192,1320,6637,0,30,2812057164
688,8.01166,198,0,6,0,171.789,235,8189,6,0,98,6,11.45,4198,1326,6643,0,30,2695975712
655,7.6274,110,0,9,0,150.447,253,8191,8,0,137,9,16.9711,4206,1335,6652,0,30,2760688708
764,8.89699,116,0,18,0,108.731,257,8191,19,0,34,18,14.1873,4225,1353,6670,0,30,2768232323
649,7.55739,193,0,13,0,179.663,269,8187,13,0,101,13,19.1726,4238,1366,6683,0,30,2314678757
264,3.07418,270,0,51,0,233.381,270,8191,51,0,6,44,19.4172,4289,1410,6734,0,30,1403114606
4,0.04658,270,0,4,0,233.381,270,8191,4,0,0,3,19.4172,4293,1413,6738,0,30,0
270,3.14416,194,0,270,0,249.502,7,8187,270,0,5,0,17.4836,4563,1413,7008,0,31,5467224322
459,5.34498,76,0,199,0,81.366,86,8191,63,0,129,5,10.0289,4626,1418,7207,0,32,4868052922
621,7.23145,128,0,11,0,113.228,128,8191,11,0,143,11,9.50477,4637,1429,7218,0,32,2676470440
787,9.16512,94,0,5,0,113.63,166,8189,5,0,174,5,14.7347,4642,1434,7223,0,32,2958972554
799,9.30422,179,0,4,0,100.253,200,8189,4,0,195,4,18.9047,4646,1438,7227,0,32,2812965210
754,8.78084,155,0,5,0,267.231,240,8189,5,0,274,5,21.7701,4651,1443,7232,0,32,2704121534
612,7.12704,243,0,24,0,142.835,243,8184,24,0,23,24,16.8896,4675,1467,7256,0,32,2159731154
1,0.011645,243,0,1,0,142.835,243,8184,1,0,0,1,16.8896,4676,1468,7257,0,32,0
470,5.47275,86,0,245,0,103.707,86,8190,73,0,131,2,10.1338,4749,1470,7502,0,33,6050467122
551,6.41582,120,0,8,0,83.902,120,8189,8,0,108,8,12.6264,4757,1478,7510,0,33,2809428286
0,0,120,0,0,0,83.902,120,8189,0,0,0,0,12.6264,4757,1478,7510,0,33,0
500,5.82261,65,0,121,0,72.856,88,8191,121,0,136,1,13.3137,4878,1479,7631,0,34,5805845307
646,7.52286,85,0,8,0,133.598,127,8124,8,0,131,8,11.9741,4886,1487,7639,0,34,2783061287
677,7.88399,66,0,5,0,103.887,161,8066,5,0,155,5,13.9077,4891,1492,7644,0,34,2824910840
247,2.87661,164,0,10,0,118.521,164,8191,10,0,14,10,14.4319,4901,1502,7654,0,34,1071410748
188,2.18938,24,0,164,0,60.294,24,8189,126,0,22,0,14.2804,5027,1502,7818,0,35,4503900537
567,6.60306,97,0,4,0,134.504,104,8189,4,0,163,4,16.5285,5031,1506,7822,0,35,2714802535
613,7.13855,118,0,18,0,104.499,126,8173,17,0,79,18,15.0958,5048,1524,7840,0,35,2822553580
678,7.89542,160,0,20,0,164.422,160,8189,21,0,150,20,14.2339,5069,1544,7860,0,35,2594390364
653,7.6041,73,0,20,0,114.452,171,8190,20,0,58,20,15.2472,5089,1564,7880,0,35,2987656244
152,1.77003,171,0,6,0,110.025,171,8173,6,0,2,6,15.189,5095,1570,7886,0,35,269624670
409,4.7631,89,0,172,0,114.942,89,8190,60,0,138,1,14.3736,5155,1571,8058,0,36,5265767320
618,7.19647,132,0,6,0,101.093,132,8190,6,0,151,6,12.6847,5161,1577,8064,0,36,2627841550
672,7.82458,126,0,3,0,107.088,175,8189,3,0,203,3,18.2175,5164,1580,8067,0,36,3037093278
719,8.37277,94,0,18,0,100.786,183,8191,18,0,48,18,17.4254,5182,1598,8085,0,36,2847265134
671,7.8135,191,0,28,0,100.261,191,8191,28,0,48,27,15.7947,5210,1625,8113,0,36,2219213988
4,0.0465614,191,0,4,0,100.261,191,8191,4,0,0,4,15.7947,5214,1629,8117,0,36,0
353,4.11052,60,0,192,0,72.926,60,8191,107,0,70,1,15.7481,5321,1630,8309,0,37,5907440464
674,7.84862,71,0,3,0,137.51,132,8189,3,0,216,3,20.5704,5324,1633,8312,0,37,3038116550
663,7.72141,156,0,7,0,99.963,156,8191,7,0,108,7,17.7283,5331,1640,8319,0,37,2621730574
673,7.83624,210,0,4,0,130.819,210,8191,4,0,314,4,18.7649,5335,1644,8323,0,37,2658042064
974,11.3428,260,0,0,0,262.612,260,8189,0,0,367,0,22.6321,5335,1644,8323,0,37,3128637802
1014,11.8085,314,0,0,0,272.997,314,8189,0,0,485,0,34.7227,5335,1644,8323,0,37,2753014762
1023,11.9124,350,0,0,0,347.679,362,8191,0,0,502,0,30.3547,5335,1644,8323,0,37,2807804492
953,11.0976,276,0,0,0,397.889,405,8189,0,0,520,0,30.4479,5335,1644,8323,0,37,2801081884
918,10.6907,356,0,0,0,322.525,437,8189,0,0,425,0,23.0747,5335,1644,8323,0,37,2783832666
639,7.44135,157,0,15,0,263.832,441,8163,15,0,57,15,17.2157,5350,1659,8338,0,37,2574005627
504,5.8669,442,0,25,0,163.959,442,8181,25,0,11,22,14.0941,5375,1681,8363,0,37,1035344511
71,0.826799,3,0,442,0,157.273,3,7749,68,0,1,0,13.7097,5443,1681,8805,0,38,4618627514
524,6.10246,97,0,2,0,123.093,104,8189,2,0,182,2,12.8012,5445,1683,8807,0,38,2942528172
552,6.42769,91,0,12,0,126.169,148,8189,12,0,173,12,14.8861,5457,1695,8819,0,38,2799713994
342,3.98262,157,0,22,0,160.489,157,8191,22,0,45,22,14.3969,5479,1717,8841,0,38,1643908446
155,1.80499,6,0,157,0,167.349,6,8189,146,0,4,0,14.6066,5625,1717,8998,0,39,3948238882
477,5.55454,97,0,4,0,112.52,97,8189,4,0,159,4,15.5967,5629,1721,9002,0,39,2610069316
534,6.21868,131,0,6,0,156.858,131,8189,6,0,122,6,13.6631,5635,1727,9008,0,39,2989770466
321,3.73828,146,0,8,0,119.056,146,8156,8,0,61,8,14.6881,5643,1735,9016,0,39,1250066886
162,1.88652,23,0,146,0,78.076,23,8189,103,0,21,0,15.3754,5746,1735,9162,0,40,4327405004
551,6.41619,114,0,5,0,130.56,114,8189,5,0,196,5,16.5635,5751,1740,9167,0,40,2589899088
671,7.8138,132,0,4,0,173.09,148,8189,4,0,141,4,15.7481,5755,1744,9171,0,40,2958895436
529,6.16001,164,0,22,0,120.266,164,8168,22,0,78,22,16.6799,5777,1766,9193,0,40,2253530428
0,0,164,0,0,0,120.266,164,8168,0,0,0,0,16.6799,5777,1766,9193,0,40,0
489,5.69488,90,0,165,0,86.968,90,8189,59,0,141,1,15.3171,5836,1767,9358,0,41,6189437448
694,8.08159,154,0,1,0,145.494,157,8189,1,0,261,1,15.0376,5837,1768,9359,0,41,2701091260
732,8.5242,109,0,7,0,96.667,197,8190,7,0,220,7,15.2938,5844,1775,9366,0,41,2731501668
624,7.26608,138,0,12,0,122.74,202,8152,12,0,33,12,13.104,5856,1787,9378,0,41,2596695101
673,7.83662,210,0,24,0,106.477,210,8177,24,0,51,23,14.0125,5880,1810,9402,0,41,2768660769
0,0,210,0,0,0,106.477,210,8177,0,0,0,0,14.0125,5880,1810,9402,0,41,0
582,6.77723,67,0,212,0,121.668,104,8189,61,0,183,2,15.5151,5941,1812,9614,0,42,5949647382
605,7.0448,120,0,5,0,95.434,137,8189,5,0,126,5,14.2455,5946,1817,9619,0,42,2782828184
649,7.55748,82,0,7,0,110.311,163,8191,7,0,122,7,13.8262,5953,1824,9626,0,42,2739928328
445,5.18208,169,0,14,0,123.981,169,8165,14,0,29,14,16.1092,5967,1838,9640,0,42,1978089232
102,1.18782,18,0,169,0,79.945,18,8189,58,0,16,0,17.1924,6025,1838,9809,0,43,3699584630
704,8.19782,90,0,5,0,95.904,108,8190,5,0,182,5,18.4155,6030,1843,9814,0,43,2678424112
684,7.96457,120,0,15,0,87.036,130,8166,15,0,82,15,15.3637,6045,1858,9829,0,43,2842377916
682,7.94209,81,0,8,0,149.06,162,8136,8,0,146,8,18.532,6053,1866,9837,0,43,2857407326
647,7.53414,131,0,12,0,93.993,174,8189,12,0,65,12,19.4522,6065,1878,9849,0,43,2676375476
562,6.54392,185,0,21,0,154.615,185,8178,21,0,62,21,17.0177,6086,1899,9870,0,43,2162753196
58,0.675408,185,0,185,0,154.615,2,8178,58,0,0,0,17.0177,6144,1899,10055,0,44,0
260,3.02712,72,0,6,0,66.963,72,8190,7,0,96,5,16.412,6151,1904,10061,0,44,5062603153
95,1.10626,11,0,72,0,95.845,11,8189,72,0,9,0,15.5734,6223,1904,10133,0,45,4056903395
467,5.43846,88,0,1,0,85.802,88,8191,1,0,198,1,13.8495,6224,1905,10134,0,45,2492006160
624,7.26598,128,0,4,0,151.252,130,8189,4,0,144,4,13.6049,6228,1909,10138,0,45,3085465762
629,7.32416,154,0,11,0,134.606,166,8165,11,0,166,11,16.8081,6239,1920,10149,0,45,2670895130
685,7.97691,182,0,24,0,162.061,182,8191,24,0,89,23,17.9263,6263,1943,10173,0,45,2777147212
625,7.27849,97,0,21,0,121.948,192,8190,21,0,57,21,17.5768,6284,1964,10194,0,45,2959536000
668,7.77874,197,0,19,0,114.843,199,8170,19,0,42,19,15.387,6303,1983,10213,0,45,2421700760
6,0.0698714,199,0,4,0,114.843,199,8170,4,0,0,4,15.387,6307,1987,10217,0,45,0
401,4.66963,71,0,201,0,86.599,76,8189,60,0,105,2,15.2239,6367,1989,10418,0,46,5951696360
593,6.90579,58,0,6,0,134.779,124,8116,6,0,151,6,16.7848,6373,1995,10424,0,46,2773670760
618,7.19714,112,0,6,0,137.642,150,8126,6,0,112,6,17.2973,6379,2001,10430,0,46,2680359960
724,8.43121,167,0,8,0,119.807,174,8189,8,0,123,8,14.129,6387,2009,10438,0,46,2877029986
532,6.19506,97,0,18,0,123.789,184,8166,18,0,54,18,19.0445,6405,2027,10456,0,46,2820832674
609,7.09183,192,0,46,0,91.989,192,8170,46,0,46,42,19.0328,6451,2069,10502,0,46,2038940512
58,0.675441,192,0,192,0,91.989,2,8170,58,0,0,0,19.0328,6509,2069,10694,0,47,0
529,6.16105,82,0,2,0,66.757,89,8189,58,0,139,2,18.3223,6567,2071,10696,0,47,6381454864
617,7.18538,110,0,5,0,120.297,141,8189,5,0,188,5,17.1459,6572,2076,10701,0,47,2753648204
715,8.32633,137,0,15,0,181.854,172,8191,15,0,148,15,14.2688,6587,2091,10716,0,47,2821356963
225,2.62017,173,0,11,0,141.112,173,8191,11,0,7,11,13.8495,6598,2102,10727,0,47,576130837
290,3.37696,60,0,176,0,66.537,60,8182,63,0,71,3,12.6148,6661,2105,10903,0,48,4999957724
628,7.31333,123,0,6,0,77.765,123,8191,6,0,179,6,13.5699,6667,2111,10909,0,48,2668997136
717,8.35005,65,0,4,0,93.271,174,8189,4,0,240,4,16.016,6671,2115,10913,0,48,2951382496
713,8.30393,110,0,19,0,104.245,185,8121,19,0,61,19,15.585,6690,2134,10932,0,48,2672922932
636,7.40703,113,0,9,0,127.768,204,8191,9,0,116,9,14.5018,6699,2143,10941,0,48,2811905950
667,7.76719,97,0,9,0,129.461,218,8155,9,0,90,9,14.2339,6708,2152,10950,0,48,2811773669
428,4.98423,220,0,18,0,110.603,220,8174,18,0,14,18,13.0924,6726,2170,10968,0,48,1260193153
146,1.70014,14,0,220,0,81.312,14,8189,115,0,12,0,12.9526,6841,2170,11188,0,49,4367437788
598,6.96345,69,0,4,0,107.174,110,8189,4,0,191,4,11.6713,6845,2174,11192,0,49,2816201962
604,7.03368,138,0,9,0,108.889,138,8156,9,0,109,9,17.1692,6854,2183,11201,0,49,2443762025
1,0.0116448,138,0,1,0,108.889,138,8156,1,0,0,1,17.1692,6855,2184,11202,0,49,0
509,5.92675,78,0,144,0,88.866,85,8132,65,0,128,6,15.4452,6920,2190,11346,0,50,5855786001
554,6.4511,108,0,9,0,176.524,117,8189,9,0,101,9,14.6648,6929,2199,11355,0,50,2890907568
608,7.08022,109,0,11,0,172.777,150,8127,11,0,140,11,17.7166,6940,2210,11366,0,50,2504157788
708,8.24519,159,0,36,0,86.345,159,8172,36,0,40,36,14.327,6976,2246,11402,0,50,2949935816
275,3.20245,161,0,24,0,104.984,161,8185,24,0,13,23,12.3818,7000,2269,11426,0,50,1145157088
187,2.17746,42,0,162,0,41.461,42,8189,71,0,41,1,10.8792,7071,2270,11588,0,51,4502922366
557,6.48584,110,0,7,0,124.37,110,8191,7,0,164,7,12.4867,7078,2277,11595,0,51,2631545132
651,7.58151,131,0,29,0,108.781,131,8177,28,0,78,27,12.9759,7106,2304,11624,0,51,2879401582
739,8.60578,143,0,14,0,113.613,157,8191,15,0,119,15,12.871,7121,2319,11638,0,51,2926703740
701,8.16381,171,0,9,0,168.525,184,8189,9,0,140,9,18.8931,7130,2328,11647,0,51,2613901161
347,4.04076,185,0,18,0,142.972,185,8168,18,0,10,18,20.6286,7148,2346,11665,0,51,1518933525
151,1.75826,34,0,185,0,45.777,34,8189,58,0,32,0,15.5035,7206,2346,11850,0,52,4258852498
482,5.61245,94,0,11,0,85.164,94,8190,11,0,120,11,10.8093,7217,2357,11861,0,52,2731384200
319,3.71459,112,0,16,0,74.882,112,8170,16,0,60,15,10.7045,7233,2372,11877,0,52,1988923624
71,0.826766,3,0,112,0,78.775,3,8079,68,0,1,0,10.7977,7301,2372,11989,0,53,3368116887
531,6.1831,97,0,8,0,87.521,97,8191,8,0,161,8,12.8477,7309,2380,11997,0,53,2633062189
58,0.675367,97,0,97,0,87.521,2,8191,58,0,0,0,12.8477,7367,2380,12094,0,54,0
541,6.29988,95,0,1,0,108.8,103,8189,2,0,180,1,14.8745,7369,2381,12095,0,54,5956626668
753,8.76888,81,0,4,0,150.612,161,8189,4,0,241,4,16.8547,7373,2385,12099,0,54,2870433307
719,8.37326,78,0,4,0,296.39,209,8191,4,0,276,4,19.8016,7377,2389,12103,0,54,2785348925
697,8.11643,59,0,14,0,229.708,227,8189,14,0,126,14,17.1575,7391,2403,12117,0,54,2720912166
650,7.56849,250,0,12,0,181.81,250,8189,12,0,169,12,13.8611,7403,2415,12129,0,54,2690169490
730,8.50113,172,0,9,0,136.851,259,8147,8,0,76,9,15.2589,7411,2424,12138,0,54,2948476810
649,7.55838,220,0,19,0,197.015,268,8174,20,0,74,19,15.7481,7431,2443,12157,0,54,2563457062
54,0.628897,268,0,6,0,197.015,268,8174,6,0,0,6,15.7481,7437,2449,12163,0,54,0
443,5.15866,64,0,269,0,86.19,81,8191,94,0,116,1,13.5233,7531,2450,12432,0,55,5814438372
603,7.02098,92,0,6,0,100.575,122,8189,6,0,133,6,13.6398,7537,2456,12438,0,55,2808706146
646,7.52225,71,0,8,0,135.369,145,8189,8,0,93,8,13.4767,7545,2464,12446,0,55,2843160600
587,6.83533,152,0,15,0,109.489,152,8173,15,0,36,15,12.1023,7560,2479,12461,0,55,2624736534
58,0.675317,152,0,152,0,109.489,2,8173,58,0,0,0,12.1023,7618,2479,12613,0,56,0
372,4.33188,82,0,1,0,137.825,82,8190,63,0,120,1,11.6247,7681,2480,12614,0,56,5656964964
643,7.4873,84,0,4,0,119.447,125,8189,4,0,138,4,16.1208,7685,2484,12618,0,56,2879859741
649,7.55696,146,0,13,0,111.229,150,8138,13,0,107,13,14.6765,7698,2497,12631,0,56,2711359361
696,8.10497,98,0,23,0,102.374,167,8189,22,0,84,23,16.2606,7720,2520,12654,0,56,2807733502
220,2.56172,168,0,18,0,122.38,168,8163,19,0,5,18,17.6001,7739,2538,12672,0,56,1080094916
163,1.89812,14,0,168,0,110.898,14,8189,131,0,12,0,18.8348,7870,2538,12840,0,57,4435806740
621,7.23146,106,0,4,0,109.028,111,8191,4,0,194,4,16.3771,7874,2542,12844,0,57,2956707844
666,7.7556,154,0,5,0,127.308,154,8189,5,0,178,5,16.6333,7879,2547,12849,0,57,2744216776
614,7.14953,97,0,10,0,157.839,174,8149,10,0,104,10,17.1692,7889,2557,12859,0,57,2749614772
309,3.59678,176,0,21,0,131.606,176,8184,21,0,10,21,16.7615,7910,2578,12880,0,57,1110057830
86,1.00138,12,0,176,0,104.142,12,8189,58,0,10,0,16.9595,7968,2578,13056,0,58,4469924454
647,7.53384,72,0,5,0,103.385,105,8189,5,0,178,5,17.5186,7973,2583,13061,0,58,2898425780
619,7.20829,140,0,6,0,175.684,141,8189,6,0,136,6,19.755,7979,2589,13067,0,58,2663647108
621,7.23141,91,0,6,0,151.455,163,8069,6,0,105,6,19.8365,7985,2595,13073,0,58,2718384924
264,3.07426,167,0,16,0,175.879,167,8170,16,0,22,16,19.7084,8001,2611,13089,0,58,1142563040
211,2.45701,38,0,167,0,34.616,38,8191,105,0,37,0,18.5786,8106,2611,13256,0,59,4620262260
467,5.43833,100,0,7,0,118.786,100,8190,7,0,134,7,18.0428,8113,2618,13263,0,59,2622365032
813,9.46772,132,0,2,0,136.715,167,8189,2,0,282,2,16.3887,8115,2620,13265,0,59,2977501380
839,9.77061,218,0,2,0,163.002,218,8189,2,0,307,2,19.2308,8117,2622,13267,0,59,2459038288
1144,13.3222,267,0,0,0,225.571,284,8187,0,0,513,0,23.0281,8117,2622,13267,0,59,3123038112
817,9.51458,324,0,4,0,255.226,324,8190,4,0,382,4,26.9651,8121,2626,13271,0,59,2551945254
868,10.1082,135,0,7,0,106.59,343,8163,7,0,201,7,17.9845,8128,2633,13278,0,59,3043663974
641,7.46508,193,0,40,0,105.956,345,8191,40,0,25,39,19.0095,8168,2672,13318,0,59,2486217492
179,2.08454,345,0,27,0,105.956,345,8191,27,0,0,25,19.0095,8195,2697,13345,0,59,0
326,3.79642,42,0,345,0,50.934,42,8189,213,0,42,0,11.7295,8408,2697,13690,0,60,5902354628
561,6.53335,98,0,6,0,108.201,104,8191,6,0,141,6,8.59622,8414,2703,13696,0,60,2786600192
666,7.75587,117,0,4,0,125.191,137,8189,4,0,124,4,10.2386,8418,2707,13700,0,60,2688245583
732,8.52415,146,0,5,0,200.874,186,8178,5,0,248,5,18.3689,8423,2712,13705,0,60,2767667757
726,8.45413,86,0,11,0,150.411,202,8189,11,0,99,11,18.7183,8434,2723,13716,0,60,2914093704
637,7.41792,100,0,7,0,110.995,219,8190,7,0,114,7,15.3055,8441,2730,13723,0,60,2682071471
753,8.76909,166,0,12,0,91.151,228,8189,12,0,57,12,15.3637,8453,2742,13735,0,60,2914961999
718,8.36154,181,0,4,0,260.275,261,8191,3,0,257,4,12.8594,8456,2746,13739,0,60,2430788038
751,8.74506,269,0,7,0,149.092,269,8189,8,0,63,7,13.1156,8464,2753,13746,0,60,2763429046
624,7.2663,230,0,10,0,198.633,277,8191,10,0,74,10,13.6049,8474,2763,13756,0,60,2529630570
52,0.605582,277,0,5,0,198.633,277,8191,5,0,0,5,13.6049,8479,2768,13761,0,60,0
357,4.15721,79,0,278,0,87.537,79,8189,60,0,113,1,15.0143,8539,2769,14039,0,61,6264664488
540,6.28802,122,0,6,0,135.966,122,8190,6,0,135,6,12.0324,8545,2775,14045,0,61,2702944659
649,7.55765,77,0,11,0,150.675,146,8095,11,0,100,11,12.2071,8556,2786,14056,0,61,2814775861
675,7.86063,167,0,7,0,119.058,167,8092,7,0,103,7,15.4452,8563,2793,14063,0,61,2624166174
664,7.73211,187,0,10,0,124.922,187,8126,10,0,111,10,16.0626,8573,2803,14073,0,61,2451759894
120,1.3974,187,0,187,0,124.922,2,8126,120,0,0,0,16.0626,8693,2803,14260,0,62,0
425,4.94908,78,0,2,0,94.728,85,8189,32,0,128,2,16.3887,8725,2805,14262,0,62,6134867176
627,7.30194,128,0,8,0,137.52,128,8171,8,0,144,8,16.1092,8733,2813,14270,0,62,2755089742
605,7.04544,138,0,15,0,143.238,158,8189,15,0,132,15,13.6631,8748,2828,14285,0,62,2722274150
609,7.0915,182,0,5,0,134.939,182,8189,5,0,127,5,15.3637,8753,2833,14290,0,62,2441482974
659,7.67321,196,0,16,0,123.112,196,8172,16,0,83,16,13.4651,8769,2849,14306,0,62,3018763646
609,7.09138,194,0,6,0,193.824,216,8156,6,0,131,6,10.5531,8775,2855,14312,0,62,2583057372
25,0.291153,216,0,3,0,193.824,216,8156,3,0,0,3,10.5531,8778,2858,14315,0,62,0
158,1.83995,24,0,216,0,142.702,24,8189,95,0,22,0,11.0423,8873,2858,14531,0,63,5959175089
512,5.96152,100,0,4,0,94.514,100,8190,4,0,150,4,11.7994,8877,2862,14535,0,63,2742706747
706,8.22174,147,0,5,0,98.751,147,8191,5,0,181,5,14.6881,8882,2867,14540,0,63,2815974202
635,7.3937,74,0,4,0,110.878,182,8189,4,0,180,4,18.101,8886,2871,14544,0,63,2954315064
662,7.70923,132,0,18,0,131.252,193,8179,18,0,64,18,13.1273,8904,2889,14562,0,63,2679584082
184,2.14276,194,0,23,0,118.184,194,8178,23,0,7,22,12.6497,8927,2911,14585,0,63,650019008
258,3.00453,41,0,194,0,47.483,41,8191,145,0,40,0,10.623,9072,2911,14779,0,64,5002652884
540,6.28813,116,0,11,0,143.712,116,8160,11,0,184,11,13.0225,9083,2922,14790,0,64,2287373480
58,0.675427,116,0,116,0,143.712,2,8160,58,0,0,0,13.0225,9141,2922,14906,0,65,0
448,5.21702,89,0,1,0,93.423,89,8189,34,0,138,1,15.8646,9175,2923,14907,0,65,6095098632
599,6.97553,120,0,6,0,150.312,127,8189,6,0,129,6,13.5,9181,2929,14913,0,65,2620573172
499,5.81126,132,0,22,0,100.824,132,8170,22,0,21,22,11.9741,9203,2951,14935,0,65,2247126399
61,0.710397,3,0,132,0,100.056,3,8059,58,0,1,0,11.6596,9261,2951,15067,0,66,3449206525
438,5.09864,91,0,3,0,95.058,91,8189,3,0,143,3,8.96896,9264,2954,15070,0,66,2856465535
559,6.50921,58,0,3,0,139.456,134,8191,3,0,152,3,10.7278,9267,2957,15073,0,66,2757532181
645,7.5109,147,0,8,0,111.958,165,8174,8,0,147,8,14.3969,9275,2965,15081,0,66,2655260048
23,0.267844,165,0,5,0,111.958,165,8174,5,0,0,4,14.3969,9280,2969,15086,0,66,0
470,5.47157,88,0,168,0,96.694,88,8189,61,0,135,3,12.9642,9341,2972,15254,0,67,5727557377
628,7.31331,129,0,8,0,141.096,129,8189,8,0,139,8,10.8676,9349,2980,15262,0,67,2507142778
654,7.6162,153,0,5,0,152.548,153,8133,5,0,107,5,12.1139,9354,2985,15267,0,67,3054301089
680,7.91852,150,0,10,0,133.062,174,8164,10,0,109,10,17.1575,9364,2995,15277,0,67,2654961340
143,1.66516,175,0,11,0,128.863,175,8191,11,0,4,11,16.8081,9375,3006,15288,0,67,714121475
250,2.91109,59,0,175,0,70.44,59,8191,64,0,69,0,15.6083,9439,3006,15463,0,68,4964991203
709,8.25667,106,0,5,0,103.011,134,8191,5,0,226,5,14.164,9444,3011,15468,0,68,2955028258
154,1.79318,136,0,6,0,120.849,136,8148,6,0,9,6,14.4435,9450,3017,15474,0,68,508169088
403,4.69268,70,0,138,0,97.213,77,8126,64,0,107,2,15.9811,9514,3019,15612,0,69,5051964792
579,6.74221,101,0,7,0,108.253,120,8147,7,0,133,7,19.2425,9521,3026,15619,0,69,2697052505
699,8.13996,70,0,22,0,82.272,136,8190,22,0,65,22,16.9711,9543,3048,15641,0,69,2843060517
593,6.9061,142,0,11,0,98.211,142,8191,11,0,23,11,14.6532,9554,3059,15652,0,69,2403854622
0,0,142,0,0,0,98.211,142,8191,0,0,0,0,14.6532,9554,3059,15652,0,69,0
292,3.40052,66,0,142,0,93.807,66,8189,73,0,82,0,12.2071,9627,3059,15794,0,70,6005403862
537,6.25349,109,0,6,0,140.715,109,8189,6,0,118,6,12.3236,9633,3065,15800,0,70,2728010642
565,6.57903,134,0,4,0,147.082,139,8191,4,0,116,4,16.3072,9637,3069,15804,0,70,2911447719
427,4.97167,161,0,7,0,169.987,161,8134,7,0,102,7,18.8581,9644,3076,15811,0,70,1538306613
109,1.26935,3,0,161,0,163.801,3,8030,106,0,1,0,19.0445,9750,3076,15972,0,71,3858417302
448,5.2158,91,0,3,0,111.772,91,8191,3,0,144,3,17.3672,9753,3079,15975,0,71,2723428622
535,6.22972,146,0,2,0,176.712,146,8191,2,0,201,2,19.6269,9755,3081,15977,0,71,2703888380
638,7.42925,75,0,7,0,116.697,173,8189,7,0,136,7,20.4888,9762,3088,15984,0,71,3122257192
785,9.14124,197,0,6,0,195.492,199,8189,6,0,150,6,15.3404,9768,3094,15990,0,71,2799011278
908,10.5741,214,0,0,0,217.561,261,8187,0,0,453,0,25.2529,9768,3094,15990,0,71,2712910458
889,10.3523,293,0,6,0,235.419,293,8191,6,0,277,6,25.5441,9774,3100,15996,0,71,2868682070
680,7.9186,139,0,5,0,349.105,326,8094,5,0,318,5,23.2844,9779,3105,16001,0,71,2634956846
654,7.61551,195,0,14,0,221.589,334,8184,14,0,83,14,16.2839,9793,3119,16015,0,71,2902647204
722,8.40777,164,0,25,0,131.087,337,8158,25,0,33,25,16.9828,9818,3144,16040,0,71,2810479700
756,8.80358,152,0,5,0,261.929,348,8073,5,0,119,5,17.8214,9823,3149,16045,0,71,2594881356
806,9.38395,97,0,2,0,226.779,374,8189,2,0,288,2,18.1592,9825,3151,16047,0,71,3029956632
668,7.77931,117,0,7,0,292.49,391,8104,7,0,206,7,16.645,9832,3158,16054,0,71,2720856096
417,4.85544,392,0,8,0,342.908,392,8191,8,0,5,8,15.3521,9840,3166,16062,0,71,878368893
117,1.3625,15,0,392,0,197.481,15,8189,82,0,13,0,14.7231,9922,3166,16454,0,72,4788108640
511,5.95065,90,0,3,0,101.558,95,8191,3,0,142,3,17.8913,9925,3169,16457,0,72,2767268033
547,6.36956,116,0,5,0,149.182,131,8189,4,0,126,5,14.7813,9929,3174,16462,0,72,2760520734
569,6.62629,149,0,4,0,196.552,157,8189,4,0,121,4,13.8262,9933,3178,16466,0,72,2849694912
619,7.20863,105,0,5,0,171.142,182,8189,6,0,130,5,14.4202,9939,3183,16471,0,72,2727885980
605,7.04532,74,0,11,0,151.619,186,8158,11,0,26,11,15.7015,9950,3194,16482,0,72,2820224800
810,9.43335,209,0,4,0,151.494,209,8189,4,0,140,4,20.9664,9954,3198,16486,0,72,2856984304
585,6.81251,152,0,10,0,187.749,225,8170,10,0,106,10,21.5721,9964,3208,16496,0,72,2556941518
721,8.39624,179,0,11,0,154.24,243,8189,11,0,133,11,18.6717,9975,3219,16507,0,72,2864730092
65,0.756953,243,0,1,0,154.24,243,8189,1,0,0,1,18.6717,9976,3220,16508,0,72,0
375,4.36716,81,0,245,0,78.767,81,8187,70,0,117,2,16.3188,10046,3222,16753,0,73,5627941993
538,6.26479,117,0,5,0,115.64,117,8190,5,0,112,5,15.0376,10051,3227,16758,0,73,2819108540
764,8.8972,162,0,1,0,141.048,172,8189,1,0,248,1,22.1545,10052,3228,16759,0,73,2800938133
622,7.24349,118,0,9,0,174.295,205,8166,8,0,197,9,24.8801,10060,3237,16768,0,73,2833745910
729,8.48985,95,0,20,0,118.852,212,8134,21,0,45,20,17.8564,10081,3257,16788,0,73,2750352862
703,8.18682,130,0,21,0,100.628,221,8174,21,0,61,21,16.2373,10102,3278,16809,0,73,2849723634
437,5.08877,226,0,33,0,90.99,226,8179,33,0,37,33,17.4138,10135,3311,16842,0,73,1161463212
158,1.83873,12,0,226,0,79.679,12,8189,132,0,10,0,17.8447,10267,3311,17068,0,74,4483925301
615,7.16164,118,0,3,0,130.853,120,8131,3,0,229,3,15.9228,10270,3314,17071,0,74,2658639871
631,7.34781,114,0,12,0,110.227,136,8160,12,0,66,12,16.2606,10282,3326,17083,0,74,2816329480
484,5.63588,152,0,8,0,128.248,152,8191,8,0,73,8,17.67,10290,3334,17091,0,74,2103759312
62,0.721931,3,0,152,0,139.096,3,8039,59,0,1,0,17.9263,10349,3334,17243,0,75,3524509740
407,4.73932,58,0,3,0,88.513,80,8166,3,0,114,3,17.9612,10352,3337,17246,0,75,2807427910
624,7.2663,113,0,8,0,91.478,125,8165,8,0,142,8,12.6381,10360,3345,17254,0,75,2822149750
521,6.06759,136,0,33,0,98.142,136,8191,33,0,48,32,11.2403,10393,3377,17287,0,75,2396886164
0,0,136,0,0,0,98.142,136,8191,0,0,0,0,11.2403,10393,3377,17287,0,75,0
392,4.56457,80,0,136,0,139.299,80,8189,99,0,115,0,11.6596,10492,3377,17423,0,76,5991671888
613,7.13798,133,0,5,0,103.724,136,8190,5,0,188,5,11.1122,10497,3382,17428,0,76,2682153390
678,7.89532,74,0,16,0,98.968,148,8189,16,0,54,16,13.0924,10513,3398,17444,0,76,2895032630
783,9.11766,153,0,6,0,159.973,186,8189,6,0,200,6,19.3706,10519,3404,17450,0,76,2826354667
625,7.27865,142,0,6,0,166.454,214,8141,6,0,177,6,19.6968,10525,3410,17456,0,76,2616131753
327,3.8081,215,0,16,0,150.185,215,8191,16,0,7,16,17.9263,10541,3426,17472,0,76,1309396122
224,2.60845,6,0,215,0,143.023,6,8191,215,0,4,0,17.3672,10756,3426,17687,0,77,4367708812
461,5.3682,97,0,3,0,116.052,97,8191,3,0,159,3,15.6316,10759,3429,17690,0,77,2652454746
671,7.81385,81,0,4,0,138.864,150,8191,4,0,203,4,15.8646,10763,3433,17694,0,77,3014750979
706,8.22142,120,0,6,0,128.625,181,8149,6,0,161,6,20.8616,10769,3439,17700,0,77,2810055910
710,8.26801,194,0,19,0,112.993,194,8176,19,0,76,19,20.5238,10788,3458,17719,0,77,2792117839
747,8.69878,170,0,5,0,202.396,213,8136,5,0,121,5,19.522,10793,3463,17724,0,77,2550633394
699,8.13975,181,0,4,0,132.421,235,8189,4,0,153,4,17.8447,10797,3467,17728,0,77,2947335731
712,8.29122,153,0,3,0,133.814,259,8190,3,0,191,3,16.5984,10800,3470,17731,0,77,2656857673
252,2.93442,262,0,6,0,161.046,262,8191,6,0,22,6,16.4703,10806,3476,17737,0,77,832381340
261,3.03907,56,0,262,0,74.334,64,8189,59,0,78,0,15.1308,10865,3476,17999,0,78,4958525660
518,6.03239,116,0,5,0,114.89,116,8189,5,0,148,5,14.4202,10870,3481,18004,0,78,2512920428
630,7.33713,70,0,5,0,103.802,145,8189,5,0,118,5,15.9345,10875,3486,18009,0,78,2921016292
608,7.08003,91,0,13,0,130.828,163,8189,12,0,87,13,15.4802,10887,3499,18022,0,78,2969692716
624,7.26627,184,0,6,0,119.891,191,8191,7,0,153,6,14.9094,10894,3505,18028,0,78,2415065917
385,4.48342,195,0,15,0,139.01,195,8191,15,0,27,15,15.4452,10909,3520,18043,0,78,1528363163
151,1.75849,3,0,195,0,134.65,3,7996,148,0,1,0,15.5151,11057,3520,18238,0,79,4246148520
313,3.64475,66,0,0,0,84.65,86,8191,0,0,129,0,16.0393,11057,3520,18238,0,79,2905549996
616,7.17292,58,0,9,0,105.306,111,8189,9,0,78,9,15.0259,11066,3529,18247,0,79,2836050250
552,6.42775,113,0,14,0,130.732,124,8191,14,0,47,14,12.8827,11080,3543,18261,0,79,2635038728
188,2.18917,126,0,14,0,119.558,126,8183,14,0,9,14,12.7429,11094,3557,18275,0,79,1026523057
243,2.82977,49,0,126,0,62.055,49,8189,100,0,52,0,14.2106,11194,3557,18401,0,80,4760460869
606,7.05671,105,0,4,0,89.013,108,8189,4,0,146,4,16.6333,11198,3561,18405,0,80,2797357006
498,5.79892,125,0,5,0,125.336,139,8190,5,0,118,5,17.1459,11203,3566,18410,0,80,2504390498
652,7.59222,73,0,3,0,150.063,174,8189,3,0,171,3,15.189,11206,3569,18413,0,80,3062937990
715,8.32581,111,0,3,0,132.292,203,8189,3,0,172,3,18.7067,11209,3572,18416,0,80,2760324616
849,9.88757,230,0,2,0,122.023,233,8189,2,0,209,2,15.7947,11211,3574,18418,0,80,2852260810
617,7.18507,139,0,3,0,105.917,265,8189,2,0,249,3,16.2723,11213,3577,18421,0,80,2704714908
765,8.90827,273,0,5,0,228.089,288,8118,6,0,198,5,19.7201,11219,3582,18426,0,80,2848229426
751,8.74533,81,0,8,0,158.19,296,8157,8,0,75,8,19.1027,11227,3590,18434,0,80,2827982566
593,6.9051,299,0,35,0,138.336,299,8155,35,0,22,35,17.1459,11262,3625,18469,0,80,1802743602
2,0.0232901,299,0,2,0,138.336,299,8155,2,0,0,2,17.1459,11264,3627,18471,0,80,0
314,3.65643,14,0,299,0,135.625,14,8189,283,0,12,0,15.4685,11547,3627,18770,0,81,6163680696
454,5.2865,99,0,0,0,131.39,110,8189,0,0,191,0,12.4867,11547,3627,18770,0,81,3189343922
577,6.71905,84,0,10,0,131.611,130,8189,10,0,74,10,15.1075,11557,3637,18780,0,81,2769794380
562,6.54476,67,0,10,0,147.42,150,8189,10,0,89,10,18.1126,11567,3647,18790,0,81,2756397164
747,8.69872,155,0,6,0,221.566,192,8190,6,0,223,6,18.8232,11573,3653,18796,0,81,2788399868
756,8.80422,138,0,5,0,141.99,208,8189,5,0,105,5,15.9345,11578,3658,18801,0,81,2877256588
945,11.0044,256,0,0,0,249.88,265,8189,0,0,419,0,23.1679,11578,3658,18801,0,81,2766761352
862,10.0383,109,0,1,0,281.89,310,8109,1,0,407,1,21.013,11579,3659,18802,0,81,2792231982
1037,12.0762,322,0,3,0,257.224,342,8189,3,0,321,3,21.6653,11582,3662,18805,0,81,2768413596
1183,13.7769,332,0,0,0,272.15,393,8189,0,0,594,0,28.2464,11582,3662,18805,0,81,2841272038
660,7.68536,164,0,11,0,250.019,413,8172,11,0,246,11,20.8732,11593,3673,18816,0,81,2808686399
788,9.17418,276,0,3,0,226.752,427,8189,3,0,183,3,18.0428,11596,3676,18819,0,81,2576787911
696,8.10487,131,0,11,0,134.535,435,8166,10,0,113,11,18.5669,11606,3687,18830,0,81,2862382796
913,10.6326,444,0,7,0,208.26,444,8189,8,0,126,7,17.7632,11614,3694,18837,0,81,2679215392
607,7.06846,106,0,10,0,154.627,451,8160,9,0,97,10,15.8529,11623,3704,18847,0,81,2998401042
411,4.7859,451,0,23,0,157.511,451,8177,24,0,2,23,15.7947,11647,3727,18870,0,81,328947010
170,1.97945,5,0,451,0,153.811,5,8147,165,0,3,0,15.1308,11812,3727,19321,0,82,5225548188
458,5.33359,105,0,0,0,114.982,105,8189,0,0,184,0,14.5367,11812,3727,19321,0,82,2884002058
582,6.77715,125,0,14,0,116.611,125,8190,14,0,72,14,14.3154,11826,3741,19335,0,82,2455532408
104,1.21103,131,0,1,0,89.176,131,8191,1,0,22,1,14.5833,11827,3742,19336,0,82,602939008
276,3.21382,64,0,131,0,67.229,66,8189,58,0,82,0,16.9478,11885,3742,19467,0,83,5278011928
606,7.05723,95,0,6,0,131.744,114,8191,6,0,134,6,17.8214,11891,3748,19473,0,83,2849824488
632,7.36,67,0,5,0,93.026,155,8189,5,0,175,5,14.6998,11896,3753,19478,0,83,2769769384
625,7.2787,147,0,4,0,143.334,173,8189,4,0,90,4,14.164,11900,3757,19482,0,83,2730294196
839,9.77097,231,0,0,0,256.547,233,8189,0,0,384,0,19.1959,11900,3757,19482,0,83,2861283560
763,8.88595,235,0,3,0,288.311,281,8190,2,0,385,3,22.2593,11902,3760,19485,0,83,2555292374
681,7.92987,115,0,11,0,166.078,286,8080,12,0,44,11,18.1359,11914,3771,19496,0,83,2823373934
958,11.1565,310,0,2,0,190.142,310,8189,2,0,227,2,18.9746,11916,3773,19498,0,83,3011551186
1126,13.1122,346,0,0,0,281.007,363,8189,0,0,551,0,29.947,11916,3773,19498,0,83,2770501369
827,9.63042,344,0,0,0,358.302,396,8189,0,0,402,0,24.7171,11916,3773,19498,0,83,2741483501
705,8.20911,116,0,19,0,117.352,402,8173,19,0,70,19,17.0876,11935,3792,19517,0,83,2838309110
399,4.64616,402,0,25,0,107.236,402,8174,25,0,5,24,15.4336,11960,3816,19542,0,83,453477430
225,2.61962,6,0,402,0,102.863,6,7953,219,0,4,0,15.3288,12179,3816,19944,0,84,4919999900
573,6.67262,105,0,5,0,130.968,110,8189,5,0,199,5,14.1407,12184,3821,19949,0,84,3049535023


