SendPacket,SendRate(Mb/s),FlightSize,ReceiveRate(Mb/s),Send Loss,Recv Loss,RTT(ms),CWnd,FlowWindow,Retrans,PktSndPeriod(us),RecvACK,RecvNAK,EstimatedBandwidth(Mb/s),Retrans_Total,NAK_TotalRecv,Total Send Loss,Total Recv Loss
523,3.72565,64,0,5,0,113.834,87,8191,5,0,132,5,7.57152,5,5,5,0
660,5.04593,81,0,7,0,132.076,130,8189,7,0,147,7,9.02464,12,12,12,0
558,4.26652,153,0,12,0,104.97,153,8175,12,0,102,12,8.73402,24,24,24,0
546,4.17458,96,0,158,0,77.576,96,8190,75,0,157,5,7.90803,99,29,182,0
732,5.59671,113,0,9,0,107.782,142,8191,9,0,171,9,9.72061,108,38,191,0
499,3.81484,70,0,147,0,57.952,74,8189,62,0,111,3,9.85827,170,41,338,0
649,4.96255,89,0,10,0,115.064,124,8190,10,0,156,10,10.4778,180,51,348,0
403,3.08133,28,0,140,0,48.637,28,8191,72,0,35,13,10.6231,252,64,488,0
345,2.63783,24,0,82,0,59.381,24,8191,62,0,109,3,10.0877,314,67,570,0
695,5.31414,23,0,111,0,84.566,23,8189,72,0,189,5,12.7186,386,72,681,0
651,4.97782,69,0,5,0,85.324,95,8189,5,0,135,5,11.5255,391,77,686,0
698,5.33671,112,0,3,0,104.893,152,8189,3,0,218,3,8.25984,394,80,689,0
648,4.95477,167,0,26,0,112.553,167,8168,26,0,79,26,8.12982,420,106,715,0
378,2.88979,70,0,171,0,86.156,71,8191,134,0,92,4,8.22925,554,110,886,0
715,5.46684,73,0,7,0,96.7,130,8189,7,0,185,7,10.1948,561,117,893,0
513,3.92253,7,0,152,0,98.69,7,8191,72,0,47,13,8.64989,633,130,1045,0
416,3.18076,6,0,90,0,89.455,6,8189,62,0,129,4,7.96157,695,134,1135,0
655,5.00803,83,0,3,0,116.593,115,8189,3,0,216,3,8.63459,698,137,1138,0
534,4.0829,134,0,155,0,108.866,2,8191,79,0,74,21,8.74166,777,158,1293,0
526,4.02171,86,0,4,0,99.181,97,8189,61,0,162,4,9.3535,838,162,1297,0
715,5.46685,119,0,21,0,77.104,126,8191,22,0,101,21,10.8219,860,183,1318,0
379,2.89778,75,0,137,0,70.009,75,8191,69,0,104,9,10.6154,929,192,1455,0
702,5.36765,83,0,7,0,89.388,138,8189,7,0,212,7,9.34586,936,199,1462,0
711,5.43606,109,0,25,0,94.839,153,8174,25,0,68,24,9.27702,961,223,1487,0
435,3.3261,76,0,160,0,83.847,76,8191,78,0,106,6,8.85638,1039,229,1647,0
583,4.45734,94,0,12,0,104.425,125,8190,12,0,154,12,9.03229,1051,241,1659,0
661,5.05344,90,0,7,0,112.275,154,8189,7,0,127,7,9.25408,1058,248,1666,0
680,5.19948,141,0,14,0,114.239,171,8164,14,0,85,14,9.78944,1072,262,1680,0
444,3.39501,76,0,179,0,67.366,76,8191,139,0,105,8,8.52752,1211,270,1859,0
677,5.17631,80,0,6,0,103.99,129,8189,6,0,168,6,8.74931,1217,276,1865,0
743,5.67995,136,0,15,0,80.118,152,8161,15,0,105,15,7.97686,1232,291,1880,0
690,5.27565,128,0,16,0,97.48,174,8160,16,0,108,16,8.604,1248,307,1896,0
707,5.40569,98,0,24,0,122.451,192,8189,24,0,105,24,9.46058,1272,331,1920,0
766,5.85679,91,0,20,0,105.239,215,8161,20,0,144,20,9.9271,1292,351,1940,0
547,4.18229,50,0,242,0,97.282,5,8173,163,0,20,23,7.99981,1455,374,2182,0
587,4.48829,104,0,3,0,99.495,104,8189,3,0,181,3,9.28467,1458,377,2185,0
694,5.30626,113,0,3,0,115.549,157,8189,3,0,215,3,9.88122,1461,380,2188,0
596,4.55568,81,0,168,0,89.871,81,8189,86,0,157,3,10.9902,1547,383,2356,0
435,3.32599,90,0,82,0,97.167,92,8190,60,0,148,1,9.49117,1607,384,2438,0
644,4.92398,72,0,5,0,100.447,137,8189,5,0,161,5,7.67859,1612,389,2443,0
439,3.35672,69,0,142,0,62.151,69,8191,93,0,90,5,7.44915,1705,394,2585,0
523,3.99873,111,0,8,0,107.666,111,8191,8,0,117,8,7.68624,1713,402,2593,0
452,3.45594,57,0,112,0,65.651,79,8191,60,0,114,1,8.59635,1773,403,2705,0
744,5.68902,88,0,6,0,77.824,140,8191,6,0,208,6,8.42045,1779,409,2711,0
682,5.21485,110,0,4,0,111.477,178,8190,4,0,187,4,9.00934,1783,413,2715,0
393,3.0049,11,0,191,0,101.073,11,8189,64,0,57,5,9.58294,1847,418,2906,0
645,4.93163,74,0,4,0,126.846,115,8189,4,0,211,4,11.6861,1851,422,2910,0
682,5.21443,147,0,10,0,101.127,147,8189,10,0,132,10,10.6001,1861,432,2920,0
399,3.04851,87,0,147,0,128.294,87,8189,59,0,132,0,8.2369,1920,432,3067,0
667,5.09986,148,0,4,0,117.698,148,8191,4,0,224,4,7.51798,1924,436,3071,0
730,5.58157,104,0,6,0,169.143,182,8112,6,0,178,6,6.94438,1930,442,3077,0
709,5.42091,92,0,5,0,189.879,217,8189,5,0,218,5,7.88509,1935,447,3082,0
592,4.52633,6,0,239,0,100.796,6,8189,106,0,58,13,8.02275,2041,460,3321,0
594,4.54192,8,0,107,0,116.381,8,8189,62,0,182,4,11.7932,2103,464,3428,0
607,4.64136,114,0,2,0,98.133,114,8190,2,0,210,2,10.6078,2105,466,3430,0
666,5.0921,93,0,6,0,97.673,150,8191,6,0,150,6,7.96922,2111,472,3436,0
656,5.01625,155,0,38,0,81.323,155,8170,38,0,25,36,6.19488,2149,508,3474,0
588,4.49576,89,0,160,0,84.632,96,8189,64,0,159,5,8.59635,2213,513,3634,0
683,5.22222,87,0,11,0,105.368,136,8189,11,0,144,11,10.9596,2224,524,3645,0
626,4.78641,122,0,20,0,121.172,158,8166,20,0,101,20,7.4568,2244,544,3665,0
412,3.15017,5,0,196,0,110.001,5,8189,95,0,21,30,6.45491,2339,574,3861,0
608,4.64876,105,0,10,0,95.588,108,8189,10,0,193,9,6.43197,2349,583,3871,0
460,3.51723,60,0,119,0,70.824,80,8189,65,0,127,7,6.04192,2414,590,3990,0
698,5.33711,132,0,4,0,119.367,146,8190,4,0,233,4,10.2942,2418,594,3994,0
761,5.81866,175,0,2,0,150.075,190,8190,2,0,231,2,10.7684,2420,596,3996,0
667,5.09976,69,0,4,0,135.861,216,8189,4,0,166,4,11.3496,2424,600,4000,0
755,5.77266,152,0,12,0,142.295,233,8180,12,0,117,12,10.6537,2436,612,4012,0
328,2.50779,50,0,242,0,51.39,50,8189,98,0,53,9,9.31526,2534,621,4254,0
353,2.69919,14,0,88,0,83.03,14,8189,88,0,78,6,11.5102,2622,627,4342,0
676,5.16896,97,0,4,0,92.31,121,8190,4,0,231,4,10.5619,2626,631,4346,0
720,5.50488,66,0,18,0,79.222,146,8189,18,0,106,18,8.87933,2644,649,4364,0
523,3.9988,73,0,153,0,68.922,84,8191,65,0,127,6,6.72259,2709,655,4517,0
660,5.04638,134,0,5,0,149.961,140,8191,5,0,198,5,9.91946,2714,660,4522,0
671,5.13037,98,0,6,0,138.149,171,8191,6,0,151,6,11.1737,2720,666,4528,0
432,3.30301,27,0,184,0,64.755,27,8189,68,0,44,9,9.66707,2788,675,4712,0
684,5.22982,61,0,7,0,91.902,118,8189,7,0,208,7,8.16042,2795,682,4719,0
656,5.01559,84,0,14,0,74.147,133,8191,14,0,59,14,8.25984,2809,696,4733,0
474,3.62415,80,0,147,0,74.431,80,8189,71,0,122,12,9.36115,2880,708,4880,0
678,5.18391,125,0,10,0,102.206,125,8190,10,0,146,10,10.103,2890,718,4890,0
487,3.72356,68,0,130,0,63.965,69,8191,95,0,90,4,9.64413,2985,722,5020,0
648,4.95457,76,0,5,0,74.99,123,8189,5,0,164,5,11.082,2990,727,5025,0
678,5.18389,128,0,7,0,96.647,158,8189,7,0,154,7,10.3019,2997,734,5032,0
664,5.07677,121,0,3,0,141.054,194,8190,3,0,199,3,9.04758,3000,737,5035,0
713,5.45174,109,0,8,0,108.453,217,8189,8,0,147,8,6.57728,3008,745,5043,0
749,5.72714,95,0,11,0,128.976,232,8113,11,0,108,11,8.29808,3019,756,5054,0
655,5.00808,94,0,6,0,118.61,246,8189,6,0,104,6,8.94051,3025,762,5060,0
695,5.31391,141,0,11,0,125.426,266,8191,11,0,159,11,8.18336,3036,773,5071,0
758,5.79558,62,0,218,0,157.962,62,8191,117,0,159,6,7.83155,3153,779,5289,0
562,4.29704,122,0,7,0,132.294,122,8190,7,0,175,7,9.20819,3160,786,5296,0
438,3.34889,62,0,123,0,99.349,84,8189,61,0,125,1,10.3554,3221,787,5419,0
635,4.85504,147,0,5,0,196.712,147,8191,5,0,229,5,8.82579,3226,792,5424,0
750,5.73438,111,0,5,0,109.305,184,8191,5,0,189,5,8.32867,3231,797,5429,0
525,4.01409,196,0,11,0,140.781,196,8189,11,0,74,11,9.45293,3242,808,5440,0
545,4.16701,75,0,198,0,108.473,101,8189,60,0,174,2,11.5944,3302,810,5638,0
625,4.7787,67,0,4,0,113.698,144,8191,4,0,166,4,8.6193,3306,814,5642,0
744,5.68866,60,0,6,0,173.265,173,8191,6,0,142,6,9.3535,3312,820,5648,0
679,5.19137,88,0,7,0,93.791,199,8189,7,0,154,7,10.2177,3319,827,5655,0
673,5.14571,185,0,23,0,98.306,203,8186,23,0,25,23,9.90416,3342,850,5678,0
412,3.15041,86,0,204,0,114.442,86,8189,60,0,130,1,9.04758,3402,851,5882,0
612,4.67964,92,0,8,0,117.344,131,8189,8,0,153,8,7.89274,3410,859,5890,0
639,4.88592,73,0,9,0,113.186,164,8125,9,0,153,9,7.46445,3419,868,5899,0
722,5.5206,95,0,12,0,134.593,188,8189,12,0,132,12,9.02464,3431,880,5911,0
632,4.83245,198,0,6,0,168.488,212,8107,6,0,149,6,8.93286,3437,886,5917,0
367,2.80607,68,0,214,0,75.323,75,8189,90,0,101,2,7.77037,3527,888,6131,0
684,5.22981,124,0,9,0,84.137,128,8191,9,0,168,9,8.53517,3536,897,6140,0
658,5.03127,73,0,14,0,127.243,152,8189,14,0,109,14,8.14512,3550,911,6154,0
452,3.45598,49,0,177,0,120.098,3,8079,157,0,41,16,7.41091,3707,927,6331,0
594,4.54135,98,0,3,0,122.73,101,8189,3,0,174,3,8.4128,3710,930,6334,0
744,5.68905,158,0,3,0,168.967,160,8191,3,0,238,3,8.06099,3713,933,6337,0
696,5.32212,70,0,5,0,91.673,194,8189,5,0,189,5,9.07053,3718,938,6342,0
749,5.7269,206,0,8,0,96.105,215,8191,8,0,139,8,8.90227,3726,946,6350,0
803,6.1396,149,0,1,0,166.416,252,8189,1,0,265,1,10.3095,3727,947,6351,0
706,5.39779,114,0,9,0,160.941,269,8166,8,0,143,9,11.3955,3735,956,6360,0
757,5.78778,128,0,16,0,121.918,285,8155,17,0,139,16,12.168,3752,972,6376,0
708,5.41361,245,0,11,0,102.899,296,8189,11,0,101,11,13.3687,3763,983,6387,0
788,6.02503,150,0,3,0,191.835,315,8189,3,0,177,3,11.3267,3766,986,6390,0
659,5.03884,124,0,21,0,141.224,324,8174,21,0,89,20,10.2177,3787,1006,6411,0
367,2.80607,7,0,342,0,114.418,7,8189,77,0,9,18,9.40704,3864,1024,6753,0
669,5.11507,73,0,5,0,103.635,115,8191,5,0,216,5,8.27514,3869,1029,6758,0
642,4.90867,113,0,11,0,107.753,153,8158,11,0,159,11,8.31338,3880,1040,6769,0
708,5.4133,74,0,10,0,90.521,178,8189,10,0,129,10,9.97299,3890,1050,6779,0
876,6.69784,166,0,3,0,137.992,220,8189,3,0,261,3,11.4414,3893,1053,6782,0
662,5.0616,143,0,8,0,104.477,243,8191,8,0,168,8,11.1125,3901,1061,6790,0
735,5.61994,72,0,8,0,93.587,260,8189,8,0,135,8,9.20819,3909,1069,6798,0
391,2.98959,9,0,274,0,95.241,9,8189,100,0,14,13,9.10877,4009,1082,7072,0
448,3.42536,58,0,0,0,109.602,112,8191,0,0,205,0,9.33821,4009,1082,7072,0
554,4.23584,87,0,7,0,126.384,137,8149,7,0,96,7,10.5236,4016,1089,7079,0
462,3.53239,64,0,145,0,68.805,69,8189,102,0,93,7,10.5619,4118,1096,7224,0
626,4.78626,69,0,10,0,120.349,122,8189,10,0,160,10,9.43763,4128,1106,7234,0
655,5.00832,75,0,5,0,131.771,162,8187,5,0,174,5,8.45104,4133,1111,7239,0
646,4.93956,73,0,4,0,127.694,191,8191,4,0,163,4,8.35926,4137,1115,7243,0
666,5.09257,101,0,13,0,119.001,206,8164,13,0,94,13,10.4701,4150,1128,7256,0
616,4.70993,211,0,45,0,110.719,211,8173,45,0,30,42,8.94816,4195,1170,7301,0
442,3.37948,74,0,213,0,95.278,82,8189,62,0,119,2,9.11642,4257,1172,7514,0
569,4.35051,73,0,3,0,92.884,139,8189,3,0,197,3,10.7454,4260,1175,7517,0
744,5.68887,128,0,38,0,91.112,153,8190,38,0,63,38,9.45293,4298,1213,7555,0
585,4.47291,169,0,20,0,170.844,169,8172,20,0,82,20,9.06288,4318,1233,7575,0
333,2.54608,76,0,169,0,79.673,76,8189,60,0,104,0,8.49693,4378,1233,7744,0
622,4.75572,138,0,4,0,138.059,138,8157,4,0,209,4,9.72061,4382,1237,7748,0
476,3.63946,86,0,140,0,96.675,88,8191,61,0,135,2,10.6307,4443,1239,7888,0
596,4.55698,3,0,127,0,84.606,3,8078,73,0,81,14,10.5772,4516,1253,8015,0
512,3.91472,64,0,3,0,128.272,104,8191,3,0,183,3,9.48352,4519,1256,8018,0
434,3.31823,70,0,114,0,68.663,70,8191,63,0,107,5,8.7799,4582,1261,8132,0
445,3.40257,54,0,70,0,55.925,54,8187,70,0,167,0,6.86026,4652,1261,8202,0
690,5.27574,122,0,5,0,81.758,122,8189,5,0,187,5,8.13747,4657,1266,8207,0
663,5.06911,63,0,6,0,123.283,158,8189,6,0,159,6,9.00934,4663,1272,8213,0
695,5.31424,118,0,10,0,140.003,178,8156,10,0,106,10,11.8468,4673,1282,8223,0
741,5.66595,56,0,9,0,135.207,206,8191,9,0,164,9,9.81238,4682,1291,8232,0
707,5.40563,79,0,4,0,87.219,240,8189,4,0,241,4,9.48352,4686,1295,8236,0
716,5.47462,133,0,19,0,108.956,249,8191,19,0,71,19,10.0648,4705,1314,8255,0
450,3.44065,10,0,285,0,101.33,10,8189,92,0,22,33,9.47587,4797,1347,8540,0
668,5.10762,120,0,2,0,107.303,125,8191,2,0,249,2,8.06099,4799,1349,8542,0
662,5.06199,131,0,4,0,118.879,158,8189,4,0,149,4,6.80672,4803,1353,8546,0
715,5.46672,114,0,10,0,147.908,175,8191,10,0,90,10,7.01322,4813,1363,8556,0
542,4.144,184,0,20,0,129.681,184,8176,20,0,49,20,9.49117,4833,1383,8576,0
633,4.83987,98,0,184,0,118.517,108,8189,154,0,196,0,10.2407,4987,1383,8760,0
432,3.30302,133,0,15,0,130.966,133,8178,15,0,95,14,10.103,5002,1397,8775,0
529,4.0447,80,0,138,0,81.416,93,8189,93,0,151,5,9.09347,5095,1402,8913,0
613,4.68698,103,0,96,0,93.35,104,8189,82,0,182,3,9.88886,5177,1405,9009,0
626,4.78627,136,0,3,0,109.277,153,8189,3,0,198,3,8.9711,5180,1408,9012,0
663,5.069,78,0,6,0,93.469,188,8189,6,0,190,6,8.38221,5186,1414,9018,0
723,5.52832,114,0,30,0,115.315,204,8191,30,0,93,30,7.77802,5216,1444,9048,0
592,4.5263,214,0,40,0,124.575,214,8186,40,0,69,38,7.43386,5256,1482,9088,0
460,3.51723,85,0,222,0,68.392,85,8189,69,0,126,8,7.90803,5325,1490,9310,0
663,5.06971,77,0,108,0,102.8,83,8191,82,0,171,7,8.52752,5407,1497,9418,0
607,4.64112,111,0,4,0,156.997,139,8191,4,0,194,4,7.96922,5411,1501,9422,0
603,4.60592,155,0,17,0,169.148,164,8191,17,0,117,17,7.36502,5428,1518,9439,0
745,5.69616,150,0,31,0,102.239,177,8146,31,0,70,31,8.29808,5459,1549,9470,0
452,3.45615,76,0,179,0,69.179,81,8191,67,0,116,2,8.68813,5526,1551,9649,0
589,4.50347,3,0,135,0,88.579,3,8064,66,0,153,8,7.99216,5592,1559,9784,0
548,4.18995,73,0,3,0,106.938,113,8191,3,0,212,3,5.99603,5595,1562,9787,0
650,4.96992,130,0,14,0,94.477,130,8157,14,0,67,14,8.06864,5609,1576,9801,0
402,3.07381,42,0,138,0,43.36,42,8189,132,0,54,5,7.86979,5741,1581,9939,0
605,4.62562,107,0,4,0,100.854,110,8189,4,0,161,4,8.45869,5745,1585,9943,0
711,5.43631,64,0,8,0,94.349,148,8189,8,0,157,8,7.98451,5753,1593,9951,0
673,5.14561,121,0,6,0,130.174,173,8121,6,0,122,6,6.98262,5759,1599,9957,0
664,5.07725,114,0,6,0,145.291,192,8187,6,0,112,6,8.83344,5765,1605,9963,0
672,5.13804,94,0,8,0,119.247,224,8168,8,0,204,8,11.0131,5773,1613,9971,0
575,4.39665,46,0,238,0,50.184,46,8189,103,0,57,13,8.9864,5876,1626,10209,0
329,2.51559,29,0,55,0,65.202,29,8189,55,0,126,3,9.7359,5931,1629,10264,0
585,4.47303,34,0,0,0,54.014,38,8189,0,0,292,0,9.91946,5931,1629,10264,0
741,5.66554,110,0,2,0,138.775,137,8189,2,0,271,2,8.71872,5933,1631,10266,0
690,5.27604,88,0,4,0,118.041,172,8189,4,0,171,4,9.69766,5937,1635,10270,0
420,3.21132,19,0,185,0,87.574,19,8189,99,0,41,9,9.47587,6036,1644,10455,0
557,4.25875,42,0,92,0,47.787,42,8191,63,0,166,2,9.46058,6099,1646,10547,0
491,3.75416,5,0,105,0,123.048,5,8189,70,0,140,3,9.60589,6169,1649,10652,0
601,4.59518,84,0,3,0,99.287,104,8189,3,0,182,3,9.56765,6172,1652,10655,0
643,4.91613,112,0,5,0,83.492,140,8190,5,0,138,5,11.4949,6177,1657,10660,0
711,5.43668,127,0,22,0,104.511,153,8191,22,0,59,22,9.72061,6199,1679,10682,0
420,3.21138,67,0,162,0,69.881,70,8189,104,0,93,8,7.67094,6303,1687,10844,0
604,4.61846,73,0,14,0,116.271,123,8189,14,0,161,14,7.60211,6317,1701,10858,0
531,4.06025,7,0,150,0,109.695,7,8190,132,0,81,8,9.15466,6449,1709,11008,0
555,4.24362,101,0,4,0,76.539,101,8189,4,0,170,4,10.6843,6453,1713,11012,0
681,5.20683,121,0,9,0,122.976,133,8164,9,0,117,9,10.1718,6462,1722,11021,0
422,3.22664,60,0,143,0,56.506,64,8189,71,0,90,7,10.6001,6533,1729,11164,0
673,5.14569,86,0,10,0,93.67,111,8112,10,0,130,10,9.96534,6543,1739,11174,0
626,4.78632,77,0,7,0,108.221,149,8189,7,0,153,7,10.9519,6550,1746,11181,0
672,5.13804,155,0,34,0,99.159,155,8179,34,0,31,34,8.40515,6584,1780,11215,0
459,3.50943,84,0,158,0,89.775,84,8189,62,0,125,3,9.28467,6646,1783,11373,0
608,4.64875,68,0,9,0,106.694,123,8191,9,0,127,9,11.3649,6655,1792,11382,0
406,3.10428,52,0,136,0,52.096,52,8191,67,0,76,8,11.2196,6722,1800,11518,0
611,4.67162,78,0,5,0,108.44,117,8191,5,0,170,5,8.75696,6727,1805,11523,0
600,4.58758,67,0,7,0,214.518,157,8191,7,0,174,7,8.06099,6734,1812,11530,0
338,2.58452,4,0,170,0,162.31,4,8136,156,0,26,8,8.10688,6890,1820,11700,0
557,4.25903,84,0,7,0,103.605,99,8127,7,0,167,7,8.7952,6897,1827,11707,0
670,5.12303,101,0,11,0,136.936,137,8170,11,0,139,11,10.516,6908,1838,11718,0
385,2.94368,51,0,146,0,67.815,51,8189,111,0,58,8,10.2483,7019,1846,11864,0
485,3.70845,56,0,89,0,76.448,61,8189,62,0,151,2,9.13936,7081,1848,11953,0
617,4.71758,101,0,6,0,100.736,114,8189,6,0,143,6,9.18525,7087,1854,11959,0
660,5.04631,104,0,14,0,135.47,147,8191,14,0,137,14,8.95581,7101,1868,11973,0
406,3.10425,19,0,169,0,65.167,19,8189,77,0,37,18,8.65754,7178,1886,12142,0
578,4.41945,106,0,9,0,85.967,106,8169,9,0,173,9,8.25219,7187,1895,12151,0
481,3.6776,84,0,107,0,69.188,84,8189,96,0,125,1,7.86979,7283,1896,12258,0
639,4.88591,108,0,15,0,110.976,130,8170,15,0,155,15,9.50646,7298,1911,12273,0
502,3.83846,136,0,172,0,102.819,2,8175,123,0,24,35,9.07818,7421,1946,12445,0
612,4.67928,102,0,3,0,88.82,114,8189,16,0,216,3,8.18336,7437,1949,12448,0
589,4.50343,134,0,5,0,136.14,164,8191,5,0,217,5,8.46634,7442,1954,12453,0
250,1.91147,9,0,175,0,154.461,9,8189,69,0,12,11,7.58682,7511,1965,12628,0
436,3.33389,20,0,88,0,49.187,20,8190,63,0,133,5,6.77613,7574,1970,12716,0
457,3.49458,37,0,77,0,43.616,37,8191,72,0,151,3,6.4855,7646,1973,12793,0
562,4.29693,113,0,4,0,142.793,113,8191,4,0,185,4,7.28854,7650,1977,12797,0
646,4.93892,63,0,5,0,200.59,157,8191,5,0,187,5,8.70342,7655,1982,12802,0
667,5.09974,166,0,22,0,117.011,166,8166,22,0,43,20,7.38032,7677,2002,12824,0
401,3.06599,75,0,169,0,86.891,75,8190,132,0,102,3,6.28666,7809,2005,12993,0
613,4.6871,115,0,121,0,91.088,2,8189,64,0,118,6,8.15277,7873,2011,13114,0
515,3.93734,72,0,1,0,101.717,99,8191,58,0,169,1,12.7875,7931,2012,13115,0
561,4.28931,16,0,128,0,83.606,16,8191,74,0,87,8,10.8143,8005,2020,13243,0
602,4.60295,103,0,6,0,105.262,103,8191,6,0,165,6,8.2216,8011,2026,13249,0
776,5.93278,126,0,4,0,131.134,162,8189,4,0,248,4,7.4721,8015,2030,13253,0
805,6.15492,212,0,1,0,227.64,212,8189,1,0,289,1,11.5102,8016,2031,13254,0
664,5.07686,77,0,3,0,240.206,252,8190,3,0,292,3,11.3037,8019,2034,13257,0
256,1.95729,253,0,5,0,173.5,253,8191,5,0,5,5,10.9825,8024,2039,13262,0
506,3.86867,94,0,254,0,107.558,94,8190,124,0,152,1,8.99405,8148,2040,13516,0
715,5.46716,120,0,5,0,112.765,138,8189,5,0,160,5,9.47587,8153,2045,13521,0
677,5.17666,74,0,3,0,180.875,179,8189,3,0,205,3,9.87357,8156,2048,13524,0
723,5.52827,107,0,4,0,103.263,215,8189,4,0,224,4,10.103,8160,2052,13528,0
484,3.70079,4,0,234,0,134.145,4,8191,123,0,26,15,9.7665,8283,2067,13762,0
505,3.86141,38,0,91,0,52.505,38,8191,60,0,172,2,9.56765,8343,2069,13853,0
410,3.13481,34,0,65,0,117.499,34,8187,65,0,147,1,9.62118,8408,2070,13918,0
654,5.00043,100,0,1,0,74.999,109,8190,1,0,300,1,7.75507,8409,2071,13919,0
392,2.99719,7,0,128,0,113.08,7,8189,98,0,50,6,6.87555,8507,2077,14047,0
543,4.15173,106,0,3,0,95.285,106,8190,3,0,184,3,6.83731,8510,2080,14050,0
748,5.7193,137,0,13,0,92.266,137,8191,13,0,120,13,7.34973,8523,2093,14063,0
645,4.93147,63,0,8,0,132.971,164,8189,8,0,129,8,7.98451,8531,2101,14071,0
694,5.30625,111,0,4,0,167.693,188,8189,4,0,132,4,8.95581,8535,2105,14075,0
764,5.84147,139,0,4,0,116.129,222,8191,4,0,214,4,8.38221,8539,2109,14079,0
743,5.68092,85,0,13,0,85.421,239,8191,13,0,125,13,7.44915,8552,2122,14092,0
520,3.97588,61,0,247,0,73.764,79,8189,64,0,125,6,6.63846,8616,2128,14339,0
677,5.17687,131,0,2,0,125.01,149,8190,2,0,250,2,8.45104,8618,2130,14341,0
735,5.62043,81,0,4,0,157.308,183,8191,4,0,178,4,10.929,8622,2134,14345,0
718,5.49012,152,0,28,0,103.678,188,8191,28,0,25,28,9.49882,8650,2162,14373,0
352,2.69137,73,0,190,0,113.063,73,8190,60,0,97,2,9.04758,8710,2164,14563,0
638,4.87793,74,0,11,0,110.111,119,8189,11,0,138,11,10.5084,8721,2175,14574,0
631,4.82454,129,0,29,0,92.894,129,8191,29,0,40,28,11.4796,8750,2203,14603,0
450,3.44058,77,0,133,0,91.908,87,8189,113,0,134,4,8.87168,8863,2207,14736,0
478,3.6547,75,0,107,0,74.079,75,8189,63,0,149,4,9.9577,8926,2211,14843,0
566,4.32752,112,0,11,0,105.556,112,8191,11,0,109,11,12.0456,8937,2222,14854,0
669,5.11526,136,0,8,0,130.071,145,8140,8,0,131,8,9.42998,8945,2230,14862,0
680,5.19893,120,0,8,0,84.585,163,8189,8,0,86,8,7.83155,8953,2238,14870,0
256,1.95735,12,0,178,0,130.689,12,8189,69,0,37,10,8.17571,9022,2248,15048,0
448,3.4254,87,0,6,0,107.976,87,8191,6,0,123,6,7.4721,9028,2254,15054,0
639,4.88619,62,0,4,0,125.542,132,8191,4,0,155,4,7.11264,9032,2258,15058,0
656,5.01532,164,0,3,0,140.529,175,8189,3,0,204,3,8.32102,9035,2261,15061,0
737,5.63478,59,0,11,0,118.417,201,8189,11,0,155,11,10.9596,9046,2272,15072,0
462,3.53255,3,0,226,0,102.957,3,7988,82,0,11,22,11.2732,9128,2294,15298,0
536,4.09843,98,0,3,0,69.794,98,8191,3,0,163,3,9.98064,9131,2297,15301,0
676,5.16852,87,0,4,0,137.65,142,8191,4,0,164,4,9.62118,9135,2301,15305,0
745,5.69656,129,0,6,0,177.018,168,8190,6,0,128,6,10.0724,9141,2307,15311,0
724,5.53569,117,0,17,0,89.354,179,8191,17,0,58,17,7.88509,9158,2324,15328,0
258,1.97265,31,0,190,0,68.376,31,8189,70,0,31,11,7.4415,9228,2335,15518,0
659,5.03867,106,0,5,0,125.694,110,8189,5,0,173,5,8.54282,9233,2340,15523,0
685,5.23744,79,0,6,0,138,152,8189,6,0,174,6,11.1584,9239,2346,15529,0
785,6.00217,141,0,5,0,202.653,196,8189,5,0,242,5,10.0495,9244,2351,15534,0
725,5.54373,127,0,25,0,102.282,213,8190,25,0,108,24,9.67472,9269,2375,15559,0
491,3.75416,58,0,258,0,105.638,5,8126,203,0,21,38,8.74166,9472,2413,15817,0
520,3.97592,82,0,5,0,100.248,90,8189,36,0,138,5,7.4721,9508,2418,15822,0
658,5.03098,69,0,4,0,180.224,149,8189,4,0,221,4,10.2407,9512,2422,15826,0
619,4.73308,103,0,11,0,161.419,177,8168,11,0,143,11,9.82768,9523,2433,15837,0
528,4.03707,62,0,207,0,95.286,4,8097,163,0,21,25,8.51987,9686,2458,16044,0
347,2.65317,9,0,72,0,77.565,9,8191,72,0,94,3,7.99216,9758,2461,16116,0
539,4.1214,77,0,2,0,74.024,77,8191,2,0,239,2,10.0342,9760,2463,16118,0
689,5.26843,128,0,4,0,146.489,131,8191,4,0,176,4,10.9902,9764,2467,16122,0
467,3.57064,167,0,5,0,176.077,167,8189,5,0,167,5,10.3172,9769,2472,16127,0
514,3.93002,93,0,169,0,72.428,93,8189,61,0,150,2,9.33821,9830,2474,16296,0
618,4.72532,106,0,11,0,102.733,121,8159,11,0,93,11,8.30573,9841,2485,16307,0
676,5.16895,107,0,22,0,106.642,141,8190,21,0,81,22,8.00746,9862,2507,16329,0
683,5.22212,159,0,11,0,93.371,159,8190,12,0,84,11,9.00934,9874,2518,16340,0
676,5.16863,109,0,7,0,140.795,184,8191,7,0,137,7,10.5236,9881,2525,16347,0
668,5.10757,198,0,25,0,90.941,198,8191,25,0,86,25,10.0495,9906,2550,16372,0
561,4.28937,93,0,204,0,83.158,93,8189,116,0,150,6,9.31526,10022,2556,16576,0
548,4.18993,27,0,116,0,81.537,27,8189,86,0,120,6,8.84109,10108,2562,16692,0
666,5.09212,81,0,4,0,93.557,112,8189,4,0,186,4,10.3095,10112,2566,16696,0
630,4.81694,73,0,9,0,92.997,151,8189,9,0,161,9,8.94051,10121,2575,16705,0
741,5.66563,107,0,6,0,120.194,183,8189,6,0,167,6,8.4281,10127,2581,16711,0
654,5.00042,174,0,9,0,138.484,206,8190,9,0,138,9,10.4395,10136,2590,16720,0
713,5.45148,125,0,15,0,104.961,225,8190,15,0,129,15,10.6384,10151,2605,16735,0
728,5.5663,121,0,38,0,111.168,236,8191,37,0,82,35,9.84298,10188,2640,16773,0
537,4.10634,4,0,265,0,109.894,4,8069,128,0,47,19,9.39939,10316,2659,17038,0
554,4.23618,117,0,1,0,130.51,117,8190,1,0,226,1,7.60211,10317,2660,17039,0
707,5.40572,88,0,7,0,88.872,154,8189,7,0,157,7,7.06675,10324,2667,17046,0
467,3.57062,6,0,174,0,103.379,6,8189,86,0,23,16,8.07629,10410,2683,17220,0
663,5.06923,103,0,7,0,86.791,106,8189,7,0,186,7,7.86979,10417,2690,17227,0
660,5.04633,118,0,10,0,112.775,150,8191,10,0,177,10,8.59635,10427,2700,17237,0
692,5.29099,87,0,19,0,97.117,167,8191,19,0,82,19,8.27514,10446,2719,17256,0
709,5.42108,83,0,8,0,125.062,194,8190,8,0,155,8,8.08394,10454,2727,17264,0
732,5.5968,71,0,13,0,96.112,208,8189,13,0,90,13,8.00746,10467,2740,17277,0
608,4.64872,218,0,23,0,109.976,218,8175,23,0,67,23,8.40515,10490,2763,17300,0
553,4.22816,66,0,221,0,92.56,97,8189,62,0,160,3,9.10877,10552,2766,17521,0
681,5.20706,149,0,2,0,118.818,152,8191,2,0,216,2,8.9864,10554,2768,17523,0
452,3.45636,15,0,175,0,101.45,15,8189,98,0,73,11,9.82003,10652,2779,17698,0
680,5.19921,83,0,9,0,93.088,101,8189,9,0,160,9,10.5007,10661,2788,17707,0
631,4.8245,119,0,15,0,101.807,126,8162,14,0,91,15,9.88886,10675,2803,17722,0
628,4.80194,115,0,12,0,137.944,155,8170,13,0,126,12,9.7512,10688,2815,17734,0
383,2.92853,72,0,162,0,58.668,72,8191,65,0,97,7,10.0189,10753,2822,17896,0
557,4.25897,86,0,72,0,109.209,89,8189,72,0,210,0,12.0685,10825,2822,17968,0
715,5.46684,91,0,8,0,126.685,144,8190,8,0,200,8,9.7665,10833,2830,17976,0
398,3.04308,30,0,151,0,50.122,30,8191,122,0,31,7,9.45293,10955,2837,18127,0
604,4.61813,69,0,3,0,109.835,115,8189,3,0,193,3,9.08582,10958,2840,18130,0
710,5.42863,80,0,5,0,111.948,169,8189,5,0,243,5,8.81814,10963,2845,18135,0
718,5.48959,107,0,28,0,102.734,175,8179,28,0,28,28,8.75696,10991,2873,18163,0
374,2.85963,31,0,190,0,69.168,31,8191,152,0,35,14,8.4281,11143,2887,18353,0
639,4.88602,114,0,3,0,121.371,114,8189,3,0,187,3,8.82579,11146,2890,18356,0
660,5.0463,74,0,4,0,134.487,156,8189,4,0,178,4,9.33821,11150,2894,18360,0
712,5.44392,190,0,11,0,154.378,190,8159,11,0,188,11,11.9156,11161,2905,18371,0
275,2.10267,60,0,193,0,78.535,65,8189,62,0,81,3,11.602,11223,2908,18564,0
617,4.7174,73,0,6,0,131.409,124,8189,6,0,175,6,8.89462,11229,2914,18570,0
734,5.61191,92,0,11,0,106.933,154,8146,11,0,128,11,7.77802,11240,2925,18581,0
691,5.28365,154,0,13,0,114.71,174,8191,13,0,103,13,8.19101,11253,2938,18594,0
722,5.52067,83,0,7,0,184.302,206,8189,7,0,189,7,8.10688,11260,2945,18601,0
359,2.7451,15,0,212,0,94.358,15,8189,96,0,25,5,7.55622,11356,2950,18813,0
522,3.99127,37,0,72,0,50.552,37,8190,72,0,187,1,7.0591,11428,2951,18885,0
627,4.78936,84,0,3,0,104.423,111,8189,3,0,205,3,7.90803,11431,2954,18888,0
683,5.22213,150,0,3,0,131.245,155,8191,3,0,185,3,11.0743,11434,2957,18891,0
702,5.36743,97,0,5,0,106.298,191,8191,5,0,195,5,11.6708,11439,2962,18896,0
647,4.94698,67,0,19,0,107.648,197,8104,19,0,38,19,10.7454,11458,2981,18915,0
428,3.27244,45,0,205,0,36.16,45,8189,93,0,62,5,9.13171,11551,2986,19120,0
771,5.89515,109,0,11,0,93.189,123,8189,11,0,208,11,9.58294,11562,2997,19131,0
619,4.733,86,0,9,0,132.693,164,8126,9,0,180,9,8.65754,11571,3006,19140,0
726,5.55094,135,0,33,0,93.816,170,8191,33,0,32,33,7.40326,11604,3039,19173,0
405,3.09693,38,0,184,0,62.249,38,8189,184,0,43,13,8.26749,11788,3052,19357,0
670,5.12275,82,0,3,0,103.689,117,8191,3,0,192,3,8.32867,11791,3055,19360,0
626,4.78662,69,0,6,0,139.814,149,8191,6,0,132,6,9.58294,11797,3061,19366,0
689,5.26797,103,0,8,0,110.326,180,8191,8,0,160,8,10.2636,11805,3069,19374,0
641,4.9011,139,0,10,0,98.219,201,8189,10,0,125,10,8.53517,11815,3079,19384,0
724,5.53561,74,0,10,0,154.607,212,8132,9,0,69,10,8.2369,11824,3089,19394,0
451,3.44829,4,0,226,0,107.103,4,8189,97,0,39,9,8.71872,11921,3098,19620,0
533,4.07527,105,0,3,0,88.794,105,8189,3,0,186,3,8.13747,11924,3101,19623,0
614,4.69459,66,0,110,0,106.049,105,8191,74,0,186,5,9.3841,11998,3106,19733,0
563,4.30458,117,0,29,0,98.658,117,8191,29,0,43,29,8.35926,12027,3135,19762,0
485,3.70852,83,0,118,0,93.886,86,8189,81,0,131,1,8.48163,12108,3136,19880,0
701,5.35984,126,0,4,0,111.118,147,8191,4,0,220,4,10.5619,12112,3140,19884,0
687,5.25307,104,0,6,0,113.558,163,8191,6,0,78,6,10.0571,12118,3146,19890,0
718,5.48978,79,0,5,0,118.914,192,8189,5,0,161,5,8.52752,12123,3151,19895,0
682,5.21451,107,0,4,0,128.958,226,8189,4,0,221,4,10.2636,12127,3155,19899,0
779,5.95581,139,0,8,0,109.641,243,8191,7,0,128,8,12.3133,12134,3163,19907,0
730,5.58183,107,0,9,0,124.346,253,8189,10,0,80,9,8.7799,12144,3172,19916,0
653,4.99278,107,0,18,0,170.393,263,8170,18,0,79,16,8.78755,12162,3188,19934,0
384,2.93604,13,0,279,0,108.689,13,8189,155,0,14,15,9.49882,12317,3203,20213,0
522,3.99115,32,0,57,0,51.474,32,8189,57,0,204,1,8.71107,12374,3204,20270,0
622,4.75579,77,0,3,0,65.524,77,8189,3,0,274,3,8.46634,12377,3207,20273,0
674,5.15332,115,0,10,0,87.885,115,8189,10,0,116,10,8.99405,12387,3217,20283,0
693,5.29883,65,0,18,0,94.962,134,8189,18,0,74,17,9.1776,12405,3234,20301,0
850,6.49939,166,0,11,0,172.88,188,8189,11,0,274,11,9.98829,12416,3245,20312,0
711,5.43647,93,0,26,0,90.802,207,8191,26,0,115,26,10.4395,12442,3271,20338,0
428,3.27245,53,0,220,0,58.045,53,8189,140,0,60,13,11.8773,12582,3284,20558,0
687,5.2529,118,0,10,0,94.01,127,8191,10,0,207,10,9.77414,12592,3294,20568,0
609,4.65654,154,0,6,0,118.368,154,8191,6,0,122,6,8.9864,12598,3300,20574,0
465,3.55535,73,0,156,0,102.059,87,8187,60,0,132,2,10.0495,12658,3302,20730,0
661,5.05396,70,0,5,0,90.419,137,8191,5,0,175,5,9.27702,12663,3307,20735,0
712,5.44364,117,0,35,0,95.993,145,8191,34,0,35,34,8.66518,12697,3341,20770,0
394,3.01256,58,0,161,0,49.48,58,8189,105,0,72,14,8.9711,12802,3355,20931,0
399,3.05039,13,0,120,0,87.261,13,8191,84,0,132,13,10.0724,12886,3368,21051,0
623,4.7634,63,0,10,0,130.186,105,8191,10,0,177,10,10.2866,12896,3378,21061,0
543,4.1519,138,0,143,0,112.71,2,8190,63,0,125,5,8.08394,12959,3383,21204,0
482,3.68533,70,0,3,0,66.976,85,8191,36,0,127,3,8.02275,12995,3386,21207,0
670,5.12299,98,0,6,0,101.879,140,8189,6,0,195,6,7.75507,13001,3392,21213,0
665,5.0846,116,0,8,0,124.661,167,8189,8,0,129,8,6.78378,13009,3400,21221,0
501,3.83048,79,0,171,0,84.665,79,8189,95,0,111,4,9.02464,13104,3404,21392,0
655,5.00713,107,0,6,0,119.49,138,8191,6,0,200,6,10.0648,13110,3410,21398,0
669,5.11535,122,0,6,0,134.297,168,8191,6,0,143,6,7.92333,13116,3416,21404,0
725,5.54331,89,0,8,0,107.836,204,8191,8,0,213,8,10.0495,13124,3424,21412,0
659,5.03906,170,0,29,0,100.118,210,8159,29,0,39,28,7.58682,13153,3452,21441,0
312,2.3857,51,0,212,0,80.215,67,8191,61,0,84,2,7.2656,13214,3454,21653,0
600,4.58779,95,0,8,0,98.803,117,8189,8,0,144,8,9.32291,13222,3462,21661,0
619,4.73294,85,0,12,0,98.473,139,8190,12,0,90,12,10.5236,13234,3474,21673,0
707,5.40579,148,0,17,0,96.6,148,8191,17,0,39,17,10.906,13251,3491,21690,0
684,5.23014,108,0,16,0,108.529,159,8191,16,0,52,16,8.90992,13267,3507,21706,0
677,5.17648,166,0,11,0,125.726,185,8191,11,0,144,11,8.96346,13278,3518,21717,0
585,4.47293,195,0,13,0,112.816,195,8164,13,0,56,13,9.90416,13291,3531,21730,0
465,3.55538,87,0,199,0,78.598,87,8190,64,0,132,4,9.53706,13355,3535,21929,0
692,5.29118,83,0,6,0,94.074,126,8189,6,0,129,6,10.1336,13361,3541,21935,0
485,3.70835,64,0,136,0,71.655,68,8189,83,0,122,2,12.6574,13444,3543,22071,0
593,4.53418,66,0,5,0,111.712,122,8191,5,0,162,5,11.2043,13449,3548,22076,0
687,5.25315,135,0,21,0,92.192,144,8170,21,0,91,21,8.38986,13470,3569,22097,0
388,2.96691,52,0,162,0,59.931,52,8189,110,0,64,15,7.21206,13580,3584,22259,0
604,4.61846,55,0,12,0,140.506,118,8191,12,0,177,10,8.0304,13592,3594,22271,0
665,5.0845,105,0,12,0,126.766,148,8155,12,0,123,12,9.72061,13604,3606,22283,0
431,3.29539,29,0,163,0,59.594,29,8191,118,0,36,13,8.52752,13722,3619,22446,0
698,5.33684,69,0,5,0,106.153,124,8189,5,0,227,5,9.60589,13727,3624,22451,0
742,5.67327,105,0,10,0,73.957,152,8189,10,0,121,10,7.67094,13737,3634,22461,0
695,5.31399,77,0,9,0,123.384,187,8154,9,0,186,9,7.94627,13746,3643,22470,0
634,4.84783,193,0,16,0,113.346,193,8191,16,0,36,16,8.82579,13762,3659,22486,0
517,3.95308,92,0,194,0,98.095,95,8189,127,0,155,1,8.12218,13889,3660,22680,0
664,5.07722,146,0,8,0,102.419,146,8191,8,0,192,8,7.49504,13897,3668,22688,0
456,3.48662,4,0,169,0,120.977,4,8189,78,0,15,19,6.5008,13975,3687,22857,0
708,5.4139,134,0,0,0,111.747,134,8187,0,0,295,0,8.16042,13975,3687,22857,0
766,5.85716,67,0,4,0,93.671,197,8143,4,0,323,4,9.11642,13979,3691,22861,0
706,5.39839,123,0,11,0,140.499,215,8191,11,0,117,11,8.10688,13990,3702,22872,0
484,3.70061,224,0,16,0,187.104,224,8191,16,0,60,16,8.92522,14006,3718,22888,0
540,4.12879,88,0,229,0,82.033,92,8189,99,0,146,5,9.85062,14105,3723,23117,0
584,4.46548,86,0,6,0,161.338,139,8189,6,0,169,6,9.7359,14111,3729,23123,0
609,4.65639,120,0,6,0,135.505,166,8191,6,0,132,6,8.92522,14117,3735,23129,0
592,4.52636,174,0,29,0,103.421,174,8191,29,0,39,28,8.12982,14146,3763,23158,0
562,4.29694,90,0,175,0,84.747,93,8189,108,0,151,1,8.48163,14254,3764,23333,0
639,4.88568,95,0,7,0,120.644,147,8189,7,0,201,7,8.72637,14261,3771,23340,0
409,3.12717,56,0,158,0,43.564,56,8189,118,0,67,10,8.2369,14379,3781,23498,0
589,4.50353,118,0,5,0,133.922,120,8190,5,0,178,5,8.12218,14384,3786,23503,0
624,4.77146,81,0,7,0,119.744,138,8189,7,0,73,7,8.94051,14391,3793,23510,0
656,5.01645,65,0,7,0,111.057,161,8191,7,0,104,7,9.91181,14398,3800,23517,0
702,5.36788,170,0,5,0,132.406,194,8191,4,0,184,5,8.90992,14402,3805,23522,0
684,5.23004,74,0,5,0,101.867,217,8189,6,0,152,5,8.33632,14408,3810,23527,0
643,4.9167,101,0,14,0,112.066,225,8160,14,0,56,14,8.86403,14422,3824,23541,0
760,5.81099,150,0,16,0,109.672,236,8191,16,0,77,16,9.10877,14438,3840,23557,0
398,3.04308,70,0,245,0,78.946,70,8189,68,0,91,9,9.91946,14506,3849,23802,0
762,5.8266,71,0,4,0,176.423,140,8189,4,0,232,4,10.3707,14510,3853,23806,0
518,3.96088,155,0,16,0,142.584,155,8166,16,0,67,16,10.0342,14526,3869,23822,0
446,3.41007,68,0,156,0,70.457,75,8191,125,0,101,1,11.0514,14651,3870,23978,0
676,5.16866,73,0,6,0,118.893,139,8189,5,0,215,6,11.0743,14656,3876,23984,0
653,4.99295,110,0,16,0,114.71,154,8162,17,0,71,16,11.5561,14673,3892,24000,0
408,3.1197,9,0,181,0,90.077,9,8191,83,0,21,24,10.7301,14756,3916,24181,0
653,4.993,110,0,9,0,97.874,110,8191,9,0,195,9,8.94051,14765,3925,24190,0
695,5.31444,95,0,2,0,148.49,163,8191,2,0,228,2,8.9864,14767,3927,24192,0
526,4.02204,3,0,194,0,100.984,3,8049,69,0,107,11,9.49117,14836,3938,24386,0
583,4.4579,76,0,8,0,109.26,102,8142,7,0,176,8,10.4395,14843,3946,24394,0
676,5.16866,137,0,3,0,140.789,145,8189,4,0,168,3,11.212,14847,3949,24397,0
643,4.91617,123,0,9,0,107.784,167,8191,9,0,104,9,9.07053,14856,3958,24406,0
724,5.53599,96,0,24,0,97.258,174,8191,24,0,38,24,8.47398,14880,3982,24430,0
758,5.7962,115,0,10,0,114.738,193,8189,10,0,113,10,9.99594,14890,3992,24440,0
653,4.99275,115,0,18,0,140.995,206,8167,18,0,78,18,10.2407,14908,4010,24458,0
698,5.33691,210,0,31,0,107.523,210,8191,31,0,30,30,6.69965,14939,4040,24489,0
585,4.47298,69,0,210,0,107.933,113,8191,101,0,213,0,7.2656,15040,4040,24699,0
673,5.14596,77,0,3,0,153.895,153,8189,3,0,168,3,10.0418,15043,4043,24702,0
743,5.68136,180,0,2,0,137.24,184,8189,2,0,165,2,9.01699,15045,4045,24704,0
656,5.01157,104,0,4,0,147.133,219,8189,4,0,218,4,10.3707,15049,4049,24708,0
772,5.90249,66,0,9,0,100.785,236,8183,9,0,120,9,10.0724,15058,4058,24717,0
720,5.50508,79,0,13,0,92.859,245,8191,13,0,72,13,9.53706,15071,4071,24730,0
666,5.09217,88,0,8,0,97.564,262,8191,8,0,137,8,10.5619,15079,4079,24738,0
702,5.36741,172,0,8,0,89.563,273,8191,8,0,92,8,10.4395,15087,4087,24746,0
843,6.44475,78,0,3,0,293.071,297,8189,3,0,213,3,11.059,15090,4090,24749,0
706,5.39827,99,0,7,0,163.038,309,8191,7,0,115,7,10.7378,15097,4097,24756,0
706,5.39798,225,0,13,0,111.863,313,8191,13,0,36,13,9.5447,15110,4110,24769,0
690,5.27568,85,0,4,0,124.199,328,8191,4,0,146,4,8.2369,15114,4114,24773,0
770,5.88755,163,0,7,0,115.576,342,8191,7,0,149,7,9.49882,15121,4121,24780,0
680,5.19961,123,0,7,0,146.019,362,8191,7,0,220,7,10.3477,15128,4128,24787,0
389,2.97429,362,0,16,0,132.48,362,8191,16,0,4,16,10.2483,15144,4144,24803,0
580,4.43468,87,0,364,0,113.513,105,8191,61,0,188,2,6.68435,15205,4146,25167,0
693,5.29879,77,0,15,0,88.331,143,8191,15,0,148,15,5.99603,15220,4161,25182,0
774,5.91781,60,0,16,0,91.101,164,8191,16,0,98,16,5.78954,15236,4177,25198,0
634,4.84743,128,0,4,0,172.667,188,8189,4,0,134,4,6.1337,15240,4181,25202,0
561,4.28934,5,0,201,0,140.407,5,8191,69,0,20,10,7.18147,15309,4191,25403,0
514,3.92994,107,0,0,0,106.009,113,8191,0,0,212,0,10.7378,15309,4191,25403,0
686,5.24509,98,0,9,0,150.307,150,8189,9,0,151,9,8.71107,15318,4200,25412,0
734,5.61231,108,0,6,0,103.807,177,8191,6,0,137,6,6.8832,15324,4206,25418,0
744,5.68861,110,0,6,0,141.847,211,8155,6,0,206,6,9.5447,15330,4212,25424,0
456,3.48659,7,0,228,0,106.074,7,8189,75,0,15,16,9.07053,15405,4228,25652,0
344,2.63044,86,0,5,0,154.435,86,8191,5,0,124,5,8.87933,15410,4233,25657,0
499,3.81541,82,0,90,0,80.597,93,8189,63,0,149,4,7.4415,15473,4237,25747,0
680,5.19955,131,0,11,0,123.996,131,8191,11,0,135,11,8.49693,15484,4248,25758,0
501,3.83047,152,0,9,0,107.108,152,8191,9,0,94,9,9.69766,15493,4257,25767,0
428,3.2724,75,0,153,0,62.09,75,8191,153,0,103,1,9.78944,15646,4258,25920,0
484,3.70072,70,0,77,0,83.426,76,8189,77,0,142,2,9.25408,15723,4260,25997,0
702,5.36686,113,0,5,0,121.898,123,8191,5,0,145,5,7.27325,15728,4265,26002,0
655,5.00816,105,0,16,0,97.675,142,8152,16,0,79,16,6.5161,15744,4281,26018,0
720,5.5053,115,0,21,0,156.068,158,8191,21,0,77,21,6.60787,15765,4302,26039,0
373,2.85193,52,0,173,0,62.986,52,8189,73,0,62,14,8.0457,15838,4316,26212,0
646,4.93923,72,0,8,0,124.903,124,8191,8,0,200,8,9.43763,15846,4324,26220,0
363,2.7756,20,0,139,0,65.131,20,8191,68,0,35,10,9.7665,15914,4334,26359,0
662,5.06209,120,0,2,0,147.743,122,8189,2,0,231,2,8.9711,15916,4336,26361,0
643,4.91604,156,0,8,0,193.742,159,8189,8,0,159,8,8.83344,15924,4344,26369,0
686,5.24542,61,0,11,0,142.308,189,8097,11,0,167,11,6.76848,15935,4355,26380,0
421,3.21916,5,0,209,0,128.462,5,8189,70,0,55,11,6.43962,16005,4366,26589,0
575,4.39668,102,0,6,0,102.931,102,8191,6,0,173,6,7.70918,16011,4372,26595,0
665,5.08453,140,0,4,0,186.57,158,8190,4,0,227,4,11.059,16015,4376,26599,0
683,5.22207,133,0,6,0,110.998,186,8191,6,0,153,6,12.1603,16021,4382,26605,0
572,4.37355,3,0,210,0,119.711,3,7998,76,0,42,17,10.516,16097,4399,26815,0
535,4.09008,100,0,8,0,100.517,100,8161,8,0,170,8,8.82579,16105,4407,26823,0
683,5.22209,120,0,7,0,130.693,133,8190,7,0,120,7,8.17571,16112,4414,26830,0
713,5.45154,112,0,5,0,119.923,181,8191,5,0,235,5,8.17571,16117,4419,26835,0
739,5.65024,129,0,9,0,97.262,203,8144,9,0,133,9,8.73402,16126,4428,26844,0
736,5.62798,84,0,6,0,121.56,224,8191,6,0,143,6,8.53517,16132,4434,26850,0
724,5.53545,193,0,11,0,127.368,244,8191,10,0,142,11,8.09923,16142,4445,26861,0
710,5.42894,126,0,8,0,118.514,258,8189,9,0,110,8,9.23878,16151,4453,26869,0
595,4.5495,163,0,13,0,102.916,265,8189,12,0,57,13,9.75885,16163,4466,26882,0
383,2.92829,20,0,282,0,82.92,20,8189,119,0,21,17,8.16806,16282,4483,27164,0
637,4.87019,111,0,5,0,86.377,112,8152,5,0,194,5,7.2809,16287,4488,27169,0
707,5.40598,116,0,13,0,109.437,144,8191,13,0,125,13,7.2656,16300,4501,27182,0
737,5.63504,158,0,21,0,96.732,158,8189,21,0,69,21,7.8392,16321,4522,27203,0
669,5.11513,122,0,10,0,128.464,182,8191,10,0,125,10,8.68048,16331,4532,27213,0
375,2.86723,72,0,186,0,75.568,72,8189,63,0,95,4,9.46058,16394,4536,27399,0
640,4.8934,32,0,126,0,103.417,6,8190,68,0,173,7,10.7378,16462,4543,27525,0
626,4.78631,113,0,1,0,90.889,117,8187,1,0,223,1,11.4949,16463,4544,27526,0
715,5.46681,63,0,7,0,122.737,154,8189,7,0,157,7,12.1068,16470,4551,27533,0
316,2.41611,13,0,168,0,84.571,13,8191,71,0,21,12,10.929,16541,4563,27701,0
642,4.90868,96,0,6,0,93.013,112,8191,6,0,199,6,9.1623,16547,4569,27707,0
664,5.07688,156,0,8,0,142.825,156,8190,8,0,184,8,10.5389,16555,4577,27715,0
604,4.61809,174,0,18,0,134.527,174,8171,18,0,95,17,9.06288,16573,4594,27733,0
382,2.9207,24,0,221,0,92.252,24,8191,147,0,112,0,6.79142,16720,4594,27954,0
543,4.15172,34,0,0,0,44.141,34,8191,0,0,272,0,7.00557,16720,4594,27954,0
659,5.03883,81,0,1,0,87.095,100,8189,1,0,278,1,9.40704,16721,4595,27955,0
682,5.21428,125,0,7,0,112.098,148,8191,7,0,185,7,11.1814,16728,4602,27962,0
665,5.08455,69,0,26,0,97.899,171,8189,26,0,119,26,11.755,16754,4628,27988,0
441,3.37188,29,0,186,0,53.459,29,8189,73,0,50,10,10.8219,16827,4638,28174,0
659,5.03856,72,0,4,0,101.744,110,8191,4,0,177,4,9.0017,16831,4642,28178,0
710,5.42905,92,0,5,0,91.544,163,8191,5,0,224,5,9.33056,16836,4647,28183,0
761,5.81878,165,0,18,0,128.228,183,8191,18,0,110,18,8.85638,16854,4665,28201,0
691,5.28332,120,0,15,0,181.148,202,8177,15,0,114,15,8.70342,16869,4680,28216,0
349,2.66845,3,0,218,0,162.964,3,7987,73,0,14,12,9.07053,16942,4692,28434,0
632,4.83226,103,0,3,0,101.062,104,8187,3,0,181,3,10.6307,16945,4695,28437,0
726,5.55083,11,0,139,0,98.656,29,8105,117,0,203,4,10.5695,17062,4699,28576,0
599,4.57987,104,0,5,0,100.848,104,8190,5,0,155,5,9.72826,17067,4704,28581,0
751,5.74256,149,0,3,0,109.711,149,8189,3,0,180,3,8.75696,17070,4707,28584,0
643,4.91632,119,0,8,0,176.088,174,8190,8,0,129,8,8.6193,17078,4715,28592,0
691,5.2832,105,0,15,0,202.183,199,8191,15,0,141,15,8.63459,17093,4730,28607,0
748,5.71893,94,0,9,0,149.877,222,8191,9,0,151,9,9.1929,17102,4739,28616,0
752,5.74989,89,0,14,0,110.948,235,8189,14,0,99,14,9.82003,17116,4753,28630,0
707,5.40555,114,0,13,0,110.603,249,8153,13,0,101,13,10.1336,17129,4766,28643,0
631,4.82479,257,0,20,0,105.013,257,8184,20,0,65,20,9.99594,17149,4786,28663,0
454,3.47119,13,0,330,0,79.158,13,8189,171,0,106,1,10.5084,17320,4787,28993,0
668,5.10753,80,0,2,0,65.09,101,8191,2,0,234,2,7.92333,17322,4789,28995,0
686,5.24504,95,0,5,0,87.664,146,8189,5,0,175,5,8.05334,17327,4794,29000,0
778,5.94846,147,0,4,0,122.422,179,8189,4,0,168,4,11.2273,17331,4798,29004,0
772,5.9026,75,0,9,0,100.254,198,8191,9,0,110,9,9.04758,17340,4807,29013,0
746,5.70435,116,0,9,0,101.208,226,8190,9,0,185,9,9.80474,17349,4816,29022,0
607,4.64125,232,0,12,0,100.618,232,8190,12,0,44,12,8.29043,17361,4828,29034,0
547,4.18228,66,0,232,0,90.674,114,8191,59,0,217,0,8.90227,17420,4828,29266,0
724,5.53563,98,0,11,0,93.558,149,8191,11,0,143,11,11.4796,17431,4839,29277,0
675,5.16118,70,0,18,0,121.064,163,8191,18,0,71,18,9.62118,17449,4857,29295,0
583,4.45768,168,0,35,0,95.693,168,8189,35,0,26,32,8.7952,17484,4889,29330,0
578,4.41949,86,0,171,0,123.109,99,8190,93,0,167,3,8.4281,17577,4892,29501,0
691,5.28326,120,0,30,0,91.737,120,8172,30,0,73,30,10.7607,17607,4922,29531,0
382,2.92094,62,0,132,0,41.245,62,8189,109,0,79,11,9.78179,17716,4933,29663,0
713,5.45155,101,0,15,0,97.646,126,8189,15,0,187,15,7.90038,17731,4948,29678,0
660,5.04646,106,0,7,0,173.502,159,8191,7,0,146,6,10.9137,17738,4954,29685,0
684,5.22976,164,0,27,0,92.585,164,8143,27,0,28,27,9.5753,17765,4981,29712,0
418,3.19603,83,0,164,0,98.091,86,8189,85,0,130,0,9.14701,17850,4981,29876,0
640,4.89325,74,0,6,0,110.093,139,8103,6,0,189,6,7.34208,17856,4987,29882,0
680,5.19924,132,0,10,0,101.812,159,8191,10,0,93,10,6.66141,17866,4997,29892,0
732,5.5969,93,0,4,0,83.684,197,8191,4,0,210,4,9.02464,17870,5001,29896,0
753,5.75577,93,0,17,0,94.682,211,8189,17,0,87,17,9.48352,17887,5018,29913,0
534,4.08299,9,0,225,0,93.979,9,8191,101,0,24,12,9.46822,17988,5030,30138,0
657,5.02359,89,0,8,0,75.417,103,8190,8,0,174,8,6.65376,17996,5038,30146,0
672,5.13806,134,0,14,0,119.184,134,8170,14,0,113,14,7.15853,18010,5052,30160,0
751,5.7421,105,0,21,0,118.601,159,8172,21,0,115,21,9.91946,18031,5073,30181,0
585,4.47293,169,0,31,0,104.069,169,8170,31,0,55,30,8.34397,18062,5103,30212,0
556,4.25118,78,0,172,0,67.058,84,8189,172,0,125,3,8.36691,18234,5106,30384,0
618,4.72543,114,0,4,0,110.047,140,8189,4,0,196,4,7.93098,18238,5110,30388,0
706,5.39622,118,0,23,0,95.35,156,8191,21,0,76,23,9.56,18259,5133,30411,0
312,2.38556,23,0,167,0,89.701,23,8189,101,0,25,10,8.71872,18360,5143,30578,0
732,5.59681,125,0,2,0,129.237,132,8190,2,0,267,2,7.53328,18362,5145,30580,0
691,5.28357,95,0,5,0,157.953,167,8189,5,0,164,5,7.51798,18367,5150,30585,0
701,5.35961,152,0,5,0,160.426,196,8121,5,0,165,5,7.54858,18372,5155,30590,0
767,5.86434,179,0,9,0,113.892,217,8189,9,0,137,9,9.14701,18381,5164,30599,0
575,4.39641,229,0,23,0,164.205,229,8182,23,0,85,22,11.2884,18404,5186,30622,0
331,2.53046,73,0,229,0,61.798,76,8190,59,0,104,0,10.7072,18463,5186,30851,0
722,5.52042,128,0,4,0,116.779,135,8189,4,0,196,4,9.56765,18467,5190,30855,0
790,6.03824,173,0,3,0,88.253,186,8189,3,0,255,3,9.62883,18470,5193,30858,0
591,4.51901,98,0,6,0,82.437,203,8189,5,0,105,6,7.38797,18475,5199,30864,0
713,5.45207,122,0,8,0,142.049,217,8191,9,0,95,8,5.30771,18484,5207,30872,0
513,3.92251,36,0,227,0,44.542,36,8189,97,0,51,7,6.36314,18581,5214,31099,0
717,5.48244,131,0,2,0,148.971,135,8189,2,0,264,2,10.8143,18583,5216,31101,0
783,5.98674,169,0,3,0,203.535,188,8189,3,0,272,3,11.5714,18586,5219,31104,0
690,5.27563,125,0,11,0,187.753,215,8191,11,0,170,11,10.4242,18597,5230,31115,0
774,5.91788,129,0,25,0,110.857,225,8168,25,0,69,24,8.90227,18622,5254,31140,0
724,5.5356,99,0,8,0,130.965,245,8189,8,0,148,8,8.97875,18630,5262,31148,0
495,3.7848,249,0,24,0,119.656,249,8191,24,0,30,24,7.78566,18654,5286,31172,0
605,4.62588,86,0,252,0,85.31,90,8189,192,0,140,3,8.54282,18846,5289,31424,0
595,4.54934,122,0,6,0,82.866,128,8189,6,0,130,6,10.4242,18852,5295,31430,0
691,5.28335,66,0,15,0,114.748,142,8189,15,0,60,15,8.12218,18867,5310,31445,0
720,5.50502,132,0,10,0,131.52,164,8191,10,0,103,10,8.16042,18877,5320,31455,0
767,5.86456,148,0,5,0,101.796,190,8189,4,0,145,5,8.53517,18881,5325,31460,0
818,6.25454,62,0,3,0,129.432,218,8146,4,0,179,3,12.8563,18885,5328,31463,0
675,5.16107,76,0,10,0,88.186,243,8190,10,0,179,10,10.6154,18895,5338,31473,0
625,4.77892,219,0,26,0,114.735,249,8167,25,0,53,25,9.62883,18920,5363,31499,0
510,3.89964,78,0,255,0,84.958,87,8191,66,0,133,6,11.1278,18986,5369,31754,0
663,5.06944,104,0,5,0,121.719,139,8189,5,0,186,5,9.59824,18991,5374,31759,0
719,5.49735,72,0,18,0,115.599,154,8189,18,0,67,18,9.69766,19009,5392,31777,0
720,5.50517,81,0,13,0,117.111,181,8189,13,0,144,13,9.53706,19022,5405,31790,0
754,5.76509,58,0,5,0,100.179,213,8191,5,0,198,5,6.86026,19027,5410,31795,0
792,6.05559,172,0,8,0,96.881,234,8189,8,0,142,8,7.04381,19035,5418,31803,0
718,5.48974,72,0,219,0,76.305,72,8190,171,0,182,3,9.9577,19206,5421,32022,0
449,3.43294,70,0,72,0,95.286,70,8191,65,0,163,1,10.3554,19271,5422,32094,0
639,4.88589,131,0,3,0,109.252,131,8189,3,0,190,3,10.6996,19274,5425,32097,0
531,4.06012,81,0,134,0,88.948,97,8190,62,0,160,3,11.4108,19336,5428,32231,0
659,5.03877,98,0,2,0,114.687,147,8189,2,0,194,2,8.22925,19338,5430,32233,0
669,5.11514,81,0,7,0,112.055,175,8191,7,0,141,7,7.21971,19345,5437,32240,0
743,5.68092,90,0,9,0,160.995,199,8189,9,0,138,9,8.59635,19354,5446,32249,0
637,4.87028,89,0,5,0,140.544,224,8189,5,0,165,5,12.6192,19359,5451,32254,0
733,5.60471,151,0,25,0,110.408,230,8155,25,0,46,25,9.10112,19384,5476,32279,0
427,3.265,72,0,234,0,93.036,77,8191,63,0,109,4,8.45104,19447,5480,32513,0
661,5.05444,117,0,7,0,97.543,131,8191,7,0,173,7,9.42998,19454,5487,32520,0


