SendPacket,SendRate(Mb/s),FlightSize,ReceiveRate(Mb/s),Send Loss,Recv Loss,RTT(ms),CWnd,FlowWindow,Retrans,PktSndPeriod(us),RecvACK,RecvNAK,EstimatedBandwidth(Mb/s),Retrans_Total,NAK_TotalRecv,Total Send Loss,Total Recv Loss
424,3.82622,38,0,78,0,59.428,38,8189,78,0,130,2,9.02088,78,2,78,0
446,4.30171,43,0,2,0,51.995,43,8189,2,0,191,2,8.4613,80,4,80,0
467,4.50452,47,0,5,0,90.78,47,8189,5,0,175,5,12.6099,85,9,85,0
481,4.63911,50,0,5,0,87.356,50,8189,5,0,180,5,9.63835,90,14,90,0
417,4.02242,4,0,59,0,97.636,4,8191,59,0,127,6,9.55152,149,20,149,0
399,3.84859,31,0,0,0,70.026,31,8189,0,0,194,0,10.8154,149,20,149,0
439,4.23439,37,0,2,0,73.013,37,8189,2,0,191,2,13.0344,151,22,151,0
440,4.24408,41,0,3,0,84.106,41,8189,3,0,171,3,13.3721,154,25,154,0
421,4.06074,45,0,4,0,89.637,45,8189,4,0,155,4,11.3653,158,29,158,0
488,4.70708,49,0,6,0,79.525,49,8189,6,0,178,6,10.2462,164,35,164,0
411,3.96456,26,0,54,0,44.082,26,8189,54,0,149,4,10.0532,218,39,218,0
469,4.52374,34,0,1,0,52.302,34,8189,1,0,223,1,10.0243,219,40,219,0
513,4.94815,40,0,1,0,63.184,40,8189,1,0,243,1,10.0725,220,41,220,0
526,5.07357,45,0,4,0,74.791,45,8189,4,0,206,4,11.2303,224,45,224,0
305,2.9419,4,0,52,0,94.055,4,8189,52,0,86,5,10.7189,276,50,276,0
415,4.00288,29,0,0,0,55.873,29,8189,0,0,203,0,10.3909,276,50,276,0
448,4.32124,35,0,2,0,74.462,35,8191,2,0,197,2,11.4811,278,52,278,0
456,4.39863,40,0,3,0,78.198,40,8187,3,0,178,3,9.97603,281,55,281,0
444,4.28305,44,0,4,0,70.252,44,8189,4,0,145,4,11.8381,285,59,285,0
351,3.38544,24,0,47,0,38.408,24,8191,47,0,128,2,9.1463,332,61,332,0
502,4.84235,33,0,0,0,53.896,33,8191,0,0,251,0,9.51293,332,61,332,0
469,4.52398,39,0,1,0,80.565,39,8189,1,0,222,1,10.14,333,62,333,0
448,4.32132,43,0,3,0,77.314,43,8190,3,0,172,3,9.82166,336,65,336,0
405,3.90646,46,0,3,0,86.962,46,8189,3,0,145,3,8.75074,339,68,339,0
434,4.18617,49,0,6,0,88.198,49,8160,6,0,159,6,8.13326,345,74,345,0
442,4.26338,52,0,4,0,96.615,52,8189,4,0,147,4,7.81488,349,78,349,0
518,4.99642,56,0,5,0,97.657,56,8189,5,0,186,5,7.76664,354,83,354,0
496,4.78412,58,0,8,0,86.882,58,8152,8,0,157,8,8.26834,362,91,362,0
436,4.20546,61,0,8,0,95.726,61,8189,8,0,132,8,7.4772,370,99,370,0
461,4.4467,61,0,8,0,100.288,63,8191,8,0,129,8,4.63104,378,107,378,0
482,4.64938,60,0,7,0,97.084,65,8189,7,0,152,7,5.64408,385,114,385,0
392,3.78113,3,0,73,0,87.807,3,8127,68,0,103,7,8.2008,453,121,458,0
443,4.27299,38,0,0,0,55.754,38,8189,0,0,208,0,8.45165,453,121,458,0
388,3.74241,20,0,43,0,47.863,20,8190,43,0,134,3,7.48685,496,124,501,0
457,4.40799,29,0,0,0,46.544,29,8191,0,0,232,0,7.4965,496,124,501,0
446,4.30179,35,0,3,0,60.352,35,8191,3,0,201,3,8.08502,499,127,504,0
466,4.49517,40,0,2,0,80.901,40,8189,2,0,184,2,10.0822,501,129,506,0
389,3.75238,24,0,43,0,37.654,24,8189,43,0,166,1,10.7575,544,130,549,0
411,3.96232,21,0,1,0,73.372,31,8189,1,0,199,1,9.9085,545,131,550,0
496,4.78428,38,0,1,0,53.264,38,8191,1,0,232,1,8.87616,546,132,551,0
468,4.51424,42,0,4,0,67.084,42,8189,4,0,179,4,7.84382,550,136,555,0
441,4.25369,46,0,4,0,79.392,46,8189,4,0,164,4,7.59298,554,140,559,0
490,4.72636,49,0,6,0,78.163,49,8189,6,0,159,6,8.21045,560,146,565,0
407,3.92598,29,0,51,0,54.9,29,8191,51,0,173,1,10.5067,611,147,616,0
509,4.9094,37,0,1,0,57.023,37,8189,1,0,240,1,9.8699,612,148,617,0
336,3.24091,21,0,39,0,51.842,21,8189,39,0,143,1,9.05947,651,149,656,0
427,4.11869,29,0,2,0,57.213,29,8163,2,0,193,2,10.9891,653,151,658,0
411,3.96427,17,0,34,0,30.975,17,8189,34,0,185,1,8.6639,687,152,692,0
437,4.21515,27,0,0,0,38.015,27,8189,0,0,222,0,9.56117,687,152,692,0
370,3.56885,16,0,33,0,45.312,16,8189,33,0,164,1,11.4522,720,153,725,0
462,4.45636,27,0,0,0,38.431,27,8191,0,0,231,0,10.7286,720,153,725,0
412,3.97375,33,0,2,0,65.244,33,8190,2,0,196,2,11.1531,722,155,727,0
493,4.75567,39,0,1,0,85.661,39,8189,1,0,216,1,8.39376,723,156,728,0
417,4.02253,42,0,7,0,69.539,42,8189,7,0,135,7,7.05269,730,163,735,0
456,4.39867,47,0,1,0,116.519,47,8190,1,0,215,1,8.34552,731,164,736,0
449,4.33106,50,0,6,0,91.718,50,8191,6,0,136,6,7.39037,737,170,742,0
463,4.46356,53,0,4,0,98.146,53,8191,4,0,163,4,6.70536,741,174,746,0
435,4.19576,56,0,8,0,81.884,56,8185,8,0,142,8,6.64747,749,182,754,0
489,4.71652,56,0,3,0,92.479,59,8189,3,0,166,3,10.2751,752,185,757,0
483,4.6589,61,0,4,0,74.049,61,8189,4,0,155,4,11.047,756,189,761,0
473,4.56249,61,0,5,0,107.4,64,8189,5,0,151,5,11.6741,761,194,766,0
461,4.4464,66,0,6,0,130.521,66,8189,6,0,137,6,8.23939,767,200,772,0
441,4.25365,3,0,73,0,108.845,8,8191,70,0,131,6,8.25869,837,206,845,0
406,3.91611,37,0,0,0,62.16,37,8191,0,0,194,0,7.99819,837,206,845,0
492,4.74541,43,0,3,0,84.316,43,8190,3,0,212,3,8.77003,840,209,848,0
380,3.66554,24,0,47,0,44.088,24,8189,47,0,130,3,10.1015,887,212,895,0
493,4.75541,32,0,1,0,46.201,32,8189,1,0,239,1,12.0407,888,213,896,0
465,4.48524,39,0,0,0,60.384,39,8189,0,0,235,0,10.3427,888,213,896,0
314,3.02881,23,0,40,0,51.48,23,8191,40,0,134,1,10.8444,928,214,936,0
480,4.62995,32,0,0,0,50.201,32,8189,0,0,242,0,11.375,928,214,936,0
438,4.22473,38,0,2,0,81.069,38,8191,2,0,207,2,10.0822,930,216,938,0
342,3.29877,23,0,40,0,52.318,23,8191,24,0,139,1,9.39715,954,217,978,0
415,4.0029,30,0,1,0,69.422,30,8189,1,0,197,1,8.49989,955,218,979,0
488,4.70706,37,0,1,0,67.001,37,8189,1,0,229,1,7.74734,956,219,980,0
439,4.23435,42,0,4,0,72.467,42,8191,4,0,185,4,9.47434,960,223,984,0
494,4.75837,47,0,0,0,110.828,47,8189,0,0,232,0,9.68659,960,223,984,0
411,3.96461,50,0,2,0,92.075,50,8189,2,0,161,2,8.60602,962,225,986,0
476,4.59119,53,0,4,0,98.056,53,8191,4,0,167,4,8.56742,966,229,990,0
432,4.16714,56,0,8,0,89.077,56,8190,8,0,139,8,9.71554,974,237,998,0
495,4.77454,59,0,5,0,91.95,59,8190,5,0,172,5,11.3268,979,242,1003,0
320,3.08657,30,0,61,0,56.18,30,8189,61,0,92,2,10.8636,1040,244,1064,0
458,4.41506,36,0,1,0,76.169,36,8189,1,0,214,1,8.41306,1041,245,1065,0
448,4.32122,41,0,1,0,86.074,41,8191,1,0,210,1,10.1883,1042,246,1066,0
273,2.63184,44,0,3,0,90.183,44,8191,3,0,95,3,10.2655,1045,249,1069,0
450,4.3405,47,0,4,0,73.225,47,8190,4,0,140,4,10.9312,1049,253,1073,0
481,4.63896,50,0,5,0,94.521,50,8191,5,0,173,5,11.8574,1054,258,1078,0
416,4.01242,3,0,56,0,88.951,3,8138,56,0,134,3,11.6451,1110,261,1134,0
173,1.66871,13,0,3,0,39.108,13,8191,3,0,87,0,11.1917,1113,261,1137,0
397,3.82957,24,0,0,0,38.412,24,8189,0,0,200,0,8.9244,1113,261,1137,0
471,4.5427,32,0,1,0,42.916,32,8189,1,0,224,1,5.92387,1114,262,1138,0
452,4.35925,37,0,3,0,63.465,37,8189,3,0,183,3,8.19115,1117,265,1141,0
458,4.41764,42,0,3,0,72.938,42,8190,3,0,196,3,9.6673,1120,268,1144,0
511,4.92865,46,0,3,0,69.006,46,8189,3,0,183,3,11.0663,1123,271,1147,0
400,3.85821,8,0,52,0,89.804,8,8190,52,0,154,3,12.8608,1175,274,1199,0
429,4.13717,31,0,0,0,72.011,31,8189,0,0,211,0,12.1661,1175,274,1199,0
469,4.51972,34,0,3,0,69.498,37,8189,3,0,207,3,10.5549,1178,277,1202,0
493,4.75535,42,0,2,0,63.094,42,8191,2,0,208,2,7.82453,1180,279,1204,0
455,4.38859,46,0,3,0,96.568,46,8191,3,0,172,3,10.7286,1183,282,1207,0
489,4.71689,50,0,3,0,75.371,50,8191,3,0,184,3,11.018,1186,285,1210,0
324,3.12536,28,0,51,0,68.997,28,8191,51,0,129,1,10.3234,1237,286,1261,0
509,4.90975,36,0,0,0,60.452,36,8189,0,0,255,0,12.6003,1237,286,1261,0
447,4.31155,41,0,2,0,72.839,41,8189,2,0,195,2,10.5646,1239,288,1263,0
434,4.18618,46,0,2,0,85.397,46,8191,2,0,199,2,8.98229,1241,290,1265,0
449,4.33083,49,0,3,0,93.688,49,8191,3,0,161,3,9.27173,1244,293,1268,0
448,4.32122,52,0,4,0,77.115,52,8189,4,0,155,4,10.2462,1248,297,1272,0
502,4.84207,56,0,4,0,83.09,56,8189,4,0,200,4,9.31032,1252,301,1276,0
470,4.53341,58,0,3,0,127.751,59,8191,3,0,211,3,9.13666,1255,304,1279,0
448,4.32124,63,0,2,0,102.681,63,8191,2,0,199,2,8.49024,1257,306,1281,0
478,4.61079,64,0,3,0,110.325,65,8189,3,0,130,3,9.01123,1260,309,1284,0
402,3.87751,66,0,6,0,119.667,66,8191,6,0,108,6,7.92101,1266,315,1290,0
373,3.59696,13,0,70,0,82.129,13,8191,3,0,118,2,9.49363,1269,317,1360,0
428,4.12828,38,0,1,0,76.953,38,8189,1,0,192,1,8.65426,1270,318,1361,0
393,3.7907,20,0,44,0,57.984,20,8189,44,0,141,3,9.22349,1314,321,1405,0
434,4.18624,29,0,0,0,41.721,29,8189,0,0,218,0,8.00784,1314,321,1405,0
398,3.83904,35,0,0,0,96.614,35,8190,0,0,204,0,9.56117,1314,321,1405,0
355,3.42442,40,0,1,0,100.365,40,8189,1,0,165,1,10.9505,1315,322,1406,0
434,4.18636,44,0,3,0,75.114,44,8189,3,0,163,3,14.472,1318,325,1409,0
442,4.2632,29,0,44,0,44.106,29,8191,44,0,215,0,14.5878,1362,325,1453,0
399,3.84864,35,0,0,0,68.445,35,8189,0,0,203,0,13.0827,1362,325,1453,0
373,3.59786,20,0,40,0,47.062,20,8191,40,0,145,2,11.6837,1402,327,1493,0
350,3.37607,27,0,0,0,62.239,27,8189,0,0,178,0,10.4391,1402,327,1493,0
388,3.74235,33,0,0,0,71.366,33,8189,0,0,197,0,9.4068,1402,327,1493,0
382,3.68463,14,0,40,0,71.142,14,8189,40,0,148,3,9.06912,1442,330,1533,0
293,2.82613,16,0,20,0,38.107,16,8189,20,0,142,0,8.43235,1462,330,1553,0
343,3.3084,24,0,0,0,71.347,24,8189,0,0,173,0,8.12362,1462,330,1553,0
402,3.87757,31,0,0,0,79.273,31,8189,0,0,204,0,7.22635,1462,330,1553,0
411,3.9643,36,0,3,0,94.451,36,8189,3,0,165,3,7.84382,1465,333,1556,0
375,3.61707,40,0,2,0,68.535,40,8189,2,0,153,2,7.46755,1467,335,1558,0
398,3.83894,5,0,47,0,89.189,5,8191,47,0,159,3,9.37786,1514,338,1605,0
357,3.44339,28,0,0,0,87.31,28,8189,0,0,171,0,9.79272,1514,338,1605,0
387,3.73316,34,0,0,0,80.656,34,8189,0,0,200,0,10.4681,1514,338,1605,0
460,4.43737,39,0,3,0,70.603,39,8191,3,0,183,3,7.44826,1517,341,1608,0
463,4.4662,44,0,1,0,74.835,44,8189,1,0,216,1,8.89546,1518,342,1609,0
446,4.30191,47,0,9,0,73.187,47,8190,9,0,142,9,10.14,1527,351,1618,0
536,5.17015,51,0,3,0,85.8,51,8191,3,0,203,3,8.49024,1530,354,1621,0
453,4.36945,55,0,2,0,101.527,55,8189,2,0,205,2,8.72179,1532,356,1623,0
487,4.69739,58,0,5,0,76.502,58,8189,5,0,138,5,9.50328,1537,361,1628,0
494,4.76488,60,0,1,0,110.807,61,8189,1,0,223,1,8.52883,1538,362,1629,0
283,2.72968,31,0,64,0,79.178,31,8189,61,0,101,2,8.89546,1599,364,1693,0
447,4.31154,36,0,4,0,65.903,36,8191,4,0,194,4,7.94995,1603,368,1697,0
425,4.0994,41,0,2,0,58.27,41,8191,2,0,182,2,8.59637,1605,370,1699,0
538,5.18938,46,0,2,0,78.239,46,8189,2,0,227,2,8.50954,1607,372,1701,0
355,3.4244,26,0,49,0,53.908,26,8191,49,0,146,2,6.23261,1656,374,1750,0
412,3.97394,33,0,1,0,60.349,33,8189,1,0,194,1,5.15203,1657,375,1751,0
446,4.30189,38,0,1,0,62.507,38,8189,1,0,211,1,5.63443,1658,376,1752,0
452,4.35984,43,0,3,0,81.42,43,8191,3,0,192,3,6.40627,1661,379,1755,0
447,4.31136,24,0,47,0,44.139,24,8191,47,0,177,2,8.41306,1708,381,1802,0
428,4.12834,31,0,0,0,61.131,31,8189,0,0,217,0,8.03678,1708,381,1802,0
468,4.51436,37,0,2,0,55.648,37,8191,2,0,205,2,7.38072,1710,383,1804,0
405,3.90665,42,0,3,0,85.914,42,8191,3,0,168,3,7.9789,1713,386,1807,0
487,4.69749,46,0,2,0,91.696,46,8191,2,0,209,2,12.1179,1715,388,1809,0
348,3.35666,25,0,48,0,48.993,25,8191,48,0,121,1,11.0277,1763,389,1857,0
382,3.68496,32,0,1,0,85.35,32,8191,1,0,194,1,9.23314,1764,390,1858,0
362,3.4917,19,0,36,0,52.173,19,8189,36,0,130,2,7.89206,1800,392,1894,0
341,3.28912,13,0,25,0,77.708,13,8189,25,0,166,0,7.53509,1825,392,1919,0
369,3.5592,23,0,0,0,54.022,23,8189,0,0,188,0,9.31997,1825,392,1919,0
447,4.31156,31,0,0,0,82.355,31,8191,0,0,223,0,10.3523,1825,392,1919,0
465,4.48535,3,0,38,0,66.902,3,8154,38,0,218,1,12.3687,1863,393,1957,0
362,3.49168,25,0,0,0,62.871,25,8191,0,0,178,0,11.3557,1863,393,1957,0
476,4.59129,33,0,1,0,68.965,33,8191,1,0,239,1,9.10771,1864,394,1958,0
302,2.91297,20,0,35,0,38.689,20,8191,35,0,116,1,9.10771,1899,395,1993,0
463,4.46584,29,0,0,0,54.641,29,8189,0,0,234,0,10.5356,1899,395,1993,0
395,3.80997,35,0,1,0,54.92,35,8189,1,0,187,1,10.4295,1900,396,1994,0
522,5.03517,41,0,1,0,58.418,41,8191,1,0,247,1,7.78594,1901,397,1995,0
441,4.2541,8,0,49,0,78.326,8,8189,49,0,160,4,7.74734,1950,401,2044,0
491,4.73628,30,0,0,0,46.371,30,8189,0,0,242,0,9.79272,1950,401,2044,0
428,4.12853,36,0,2,0,69.115,36,8191,2,0,203,2,12.5038,1952,403,2046,0
469,4.52385,41,0,5,0,60.229,41,8190,5,0,181,5,10.2365,1957,408,2051,0
417,4.02225,45,0,2,0,88.644,45,8189,2,0,172,2,9.60941,1959,410,2053,0
475,4.58181,49,0,2,0,76.624,49,8190,2,0,195,2,9.84096,1961,412,2055,0
497,4.79385,53,0,5,0,100.189,53,8187,5,0,203,5,11.5487,1966,417,2060,0
473,4.56236,56,0,3,0,105.021,56,8189,3,0,190,3,13.3335,1969,420,2063,0
408,3.93538,30,0,59,0,60.666,30,8189,59,0,166,2,9.8892,2028,422,2122,0
441,4.25365,36,0,3,0,67.933,36,8189,3,0,182,3,9.22349,2031,425,2125,0
346,3.33735,20,0,39,0,50.497,20,8189,39,0,149,1,9.24278,2070,426,2164,0
371,3.57874,28,0,0,0,54.558,28,8191,0,0,188,0,10.3716,2070,426,2164,0
342,3.29873,19,0,31,0,50.999,19,8189,31,0,153,1,11.1048,2101,427,2195,0
390,3.76186,28,0,0,0,64.407,28,8189,0,0,197,0,9.61906,2101,427,2195,0
451,4.35019,34,0,1,0,60.577,34,8189,1,0,216,1,8.64461,2102,428,2196,0
459,4.42734,41,0,0,0,63.404,41,8189,0,0,234,0,7.9403,2102,428,2196,0
410,3.95464,45,0,1,0,109.115,45,8189,1,0,207,1,6.7536,2103,429,2197,0
411,3.96463,49,0,1,0,70.418,49,8189,1,0,166,1,6.85008,2104,430,2198,0
415,4.00316,52,0,3,0,88.962,52,8190,3,0,165,3,7.68946,2107,433,2201,0
462,4.45642,55,0,4,0,67.526,55,8189,4,0,135,4,8.96299,2111,437,2205,0
401,3.86797,21,0,63,0,63.029,21,8191,63,0,111,7,9.55152,2174,444,2268,0
449,4.33084,34,0,1,0,65.959,34,8189,1,0,211,1,11.0084,2175,445,2269,0
510,4.91935,40,0,1,0,60.671,40,8191,1,0,243,1,9.86026,2176,446,2270,0
470,4.53343,45,0,1,0,94.831,45,8189,1,0,216,1,9.49363,2177,447,2271,0
428,4.12833,49,0,6,0,80.814,49,8189,6,0,149,6,10.5067,2183,453,2277,0
367,3.5399,28,0,49,0,41.346,28,8191,49,0,151,0,11.1531,2232,453,2326,0
373,3.59753,19,0,1,0,78.394,34,8189,1,0,183,1,10.5067,2233,454,2327,0
373,3.598,16,0,40,0,55.244,16,8189,40,0,138,2,9.39715,2273,456,2367,0
362,3.4917,26,0,0,0,52.026,26,8189,0,0,181,0,9.57082,2273,456,2367,0
466,4.49493,34,0,1,0,79.184,34,8189,1,0,220,1,8.99194,2274,457,2368,0
327,3.15441,19,0,37,0,37.044,19,8189,37,0,127,2,9.00158,2311,459,2405,0
409,3.9448,28,0,0,0,57.068,28,8189,0,0,207,0,10.9987,2311,459,2405,0
476,4.59125,35,0,0,0,70.564,35,8189,0,0,241,0,10.3041,2311,459,2405,0
397,3.8292,39,0,3,0,73.207,39,8191,3,0,150,3,10.7286,2314,462,2408,0
456,4.39874,44,0,2,0,75.714,44,8189,2,0,193,2,9.8699,2316,464,2410,0
459,4.42758,48,0,4,0,77.586,48,8189,4,0,191,4,10.4777,2320,468,2414,0
467,4.50472,4,0,54,0,83.591,4,8189,54,0,142,3,11.8188,2374,471,2468,0
347,3.34718,30,0,0,0,77.445,30,8189,0,0,167,0,12.1854,2374,471,2468,0
497,4.79378,37,0,1,0,65.143,37,8191,1,0,236,1,11.375,2375,472,2469,0
482,4.64893,43,0,1,0,66.903,43,8187,1,0,232,1,8.84722,2376,473,2470,0
467,4.50446,46,0,4,0,73.01,46,8189,4,0,155,4,8.43235,2380,477,2474,0
336,3.2409,27,0,47,0,94.598,27,8191,47,0,137,1,10.9215,2427,478,2521,0
377,3.63663,33,0,0,0,57.334,33,8189,0,0,191,0,12.0214,2427,478,2521,0
491,4.73593,40,0,0,0,60.024,40,8189,0,0,247,0,10.0629,2427,478,2521,0
426,4.10905,42,0,1,0,80.002,44,8189,1,0,201,1,9.59011,2428,479,2522,0
462,4.45588,48,0,3,0,87.388,48,8189,3,0,170,3,11.3364,2431,482,2525,0
450,4.3405,51,0,5,0,88.844,51,8190,5,0,160,5,11.867,2436,487,2530,0
473,4.5625,54,0,3,0,96.166,54,8189,3,0,163,3,11.4715,2439,490,2533,0
400,3.8582,55,0,5,0,105.319,57,8189,5,0,125,5,11.5294,2444,495,2538,0
448,4.32135,58,0,4,0,79.47,59,8189,4,0,117,4,9.43574,2448,499,2542,0
178,1.71684,29,0,60,0,101.39,29,8191,60,0,48,1,7.236,2508,500,2602,0
415,4.00317,35,0,1,0,65.153,35,8191,1,0,197,1,6.40627,2509,501,2603,0
421,4.06104,39,0,42,0,61.642,2,8189,42,0,158,3,10.4681,2551,504,2645,0
363,3.50167,24,0,0,0,52.526,26,8189,0,0,178,0,12.8029,2551,504,2645,0
432,4.16692,33,0,1,0,61.077,33,8189,1,0,203,1,10.5742,2552,505,2646,0
473,4.56212,39,0,1,0,68.396,39,8189,1,0,224,1,9.65765,2553,506,2647,0
448,4.32102,3,0,45,0,73.082,3,8148,45,0,185,2,10.497,2598,508,2692,0
328,3.1637,26,0,0,0,56.537,26,8189,0,0,161,0,9.3875,2598,508,2692,0
437,4.21513,34,0,0,0,58.623,34,8189,0,0,225,0,9.45504,2598,508,2692,0
470,4.53342,40,0,1,0,58.204,40,8190,1,0,221,1,10.6032,2599,509,2693,0
510,4.91923,45,0,2,0,78.485,45,8191,2,0,218,2,11.0663,2601,511,2695,0
426,4.10898,49,0,2,0,89.441,49,8189,2,0,193,2,9.35856,2603,513,2697,0
279,2.69114,25,0,51,0,51.72,25,8191,51,0,83,1,9.46469,2654,514,2748,0
444,4.28261,33,0,0,0,61.729,33,8189,0,0,225,0,10.6224,2654,514,2748,0
496,4.78447,39,0,2,0,83.916,39,8191,2,0,233,2,9.02088,2656,516,2750,0
323,3.11552,21,0,42,0,44.413,21,8189,42,0,118,1,8.81827,2698,517,2792,0
436,4.20543,29,0,1,0,51.429,29,8163,1,0,206,1,8.26834,2699,518,2793,0
329,3.17352,22,0,29,0,55.683,22,8191,29,0,163,0,9.09806,2728,518,2822,0
403,3.88734,30,0,0,0,45.758,30,8189,0,0,206,0,7.41931,2728,518,2822,0
462,4.45643,36,0,1,0,65.413,36,8189,1,0,216,1,6.22296,2729,519,2823,0
358,3.45314,40,0,1,0,109.273,40,8191,1,0,161,1,5.35464,2730,520,2824,0
438,4.22478,45,0,2,0,85.176,45,8189,2,0,203,2,6.96586,2732,522,2826,0
307,2.96121,25,0,46,0,48.568,25,8189,46,0,125,1,9.65765,2778,523,2872,0
417,4.02223,32,0,1,0,53.844,32,8191,1,0,200,1,8.30693,2779,524,2873,0
445,4.29225,38,0,2,0,59.594,38,8189,2,0,192,2,9.46469,2781,526,2875,0
457,4.40802,42,0,3,0,73.676,42,8190,3,0,198,3,9.95674,2784,529,2878,0
476,4.59121,46,0,3,0,70.456,46,8189,3,0,158,3,10.9408,2787,532,2881,0
461,4.44672,50,0,3,0,76.109,50,8189,3,0,187,3,9.4068,2790,535,2884,0
414,3.99325,53,0,6,0,82.333,53,8189,6,0,136,6,6.74395,2796,541,2890,0
383,3.69428,27,0,58,0,51.369,27,8191,58,0,104,4,6.55099,2854,545,2948,0
465,4.48518,34,0,2,0,58.02,34,8191,2,0,210,2,7.66051,2856,547,2950,0
455,4.38874,39,0,2,0,76.406,39,8191,2,0,199,2,8.09467,2858,549,2952,0
283,2.72985,23,0,40,0,54.697,23,8189,40,0,116,1,8.2008,2898,550,2992,0
445,4.29227,31,0,0,0,59.434,31,8189,0,0,224,0,7.40002,2898,550,2992,0
461,4.44687,37,0,2,0,73.701,37,8190,2,0,216,2,8.60602,2900,552,2994,0
467,4.50478,42,0,1,0,60.544,42,8189,1,0,199,1,8.86651,2901,553,2995,0
498,4.80359,47,0,2,0,83.342,47,8189,2,0,211,2,8.55778,2903,555,2997,0
390,3.76173,4,0,54,0,85.758,4,8191,54,0,125,4,9.4068,2957,559,3051,0
433,4.17656,31,0,0,0,57.319,31,8189,0,0,209,0,9.69624,2957,559,3051,0
478,4.61059,38,0,2,0,63.894,38,8190,2,0,224,2,9.9085,2959,561,3053,0
455,4.38873,4,0,44,0,73.208,4,8190,44,0,157,3,8.72179,3003,564,3097,0
337,3.25083,26,0,0,0,42.453,26,8189,0,0,163,0,8.77003,3003,564,3097,0
363,3.50129,32,0,0,0,51.615,32,8189,0,0,184,0,10.0146,3003,564,3097,0
465,4.48515,39,0,0,0,70.682,39,8189,0,0,235,0,11.8574,3003,564,3097,0
433,4.17651,4,0,45,0,71.848,4,8191,45,0,180,2,10.7768,3048,566,3142,0
303,2.92266,26,0,0,0,55.948,26,8191,0,0,148,0,11.1627,3048,566,3142,0
384,3.704,33,0,0,0,56.931,33,8189,0,0,194,0,9.27173,3048,566,3142,0
414,3.99308,38,0,1,0,56.792,38,8189,1,0,194,1,8.74109,3049,567,3143,0
464,4.47537,42,0,3,0,81.635,42,8189,3,0,179,3,7.6991,3052,570,3146,0
459,4.42718,46,0,3,0,81.192,46,8189,3,0,172,3,7.54474,3055,573,3149,0
477,4.60126,49,0,4,0,75.273,50,8189,4,0,176,4,6.36768,3059,577,3153,0
476,4.59149,53,0,4,0,91.263,53,8191,4,0,166,4,7.14917,3063,581,3157,0
364,3.51117,29,0,55,0,60.158,29,8189,55,0,146,2,7.82453,3118,583,3212,0
484,4.66847,37,0,0,0,65.585,37,8191,0,0,244,0,8.19115,3118,583,3212,0
455,4.38867,42,0,3,0,72.889,42,8190,3,0,212,3,8.97264,3121,586,3215,0
435,4.19582,45,0,4,0,85.495,45,8191,4,0,139,4,7.90171,3125,590,3219,0
392,3.7811,27,0,46,0,41.541,27,8189,46,0,167,1,9.07877,3171,591,3265,0
436,4.20574,34,0,1,0,70.023,34,8191,1,0,223,1,10.1786,3172,592,3266,0
375,3.61718,38,0,3,0,61.776,38,8189,3,0,144,3,10.333,3175,595,3269,0
501,4.8324,43,0,2,0,63.778,43,8189,2,0,199,2,11.9056,3177,597,3271,0
444,4.28269,47,0,3,0,78.629,47,8191,3,0,186,3,11.7416,3180,600,3274,0
337,3.25076,27,0,47,0,65.737,27,8189,47,0,140,0,12.3398,3227,600,3321,0
437,4.21511,34,0,0,0,59.033,34,8189,0,0,222,0,9.41645,3227,600,3321,0
434,4.1862,40,0,2,0,75.258,40,8189,2,0,203,2,10.5935,3229,602,3323,0
430,4.14778,24,0,42,0,40.442,24,8190,42,0,173,1,9.8892,3271,603,3365,0
447,4.3115,31,0,2,0,52.553,31,8191,2,0,202,2,9.43574,3273,605,3367,0
433,4.17644,36,0,4,0,61.709,36,8189,4,0,172,4,9.45504,3277,609,3371,0
496,4.7844,41,0,4,0,68.918,41,8191,4,0,199,4,10.7093,3281,613,3375,0
486,4.68803,46,0,4,0,79.958,46,8191,4,0,207,4,10.6224,3285,617,3379,0
461,4.4468,49,0,6,0,94.322,49,8189,6,0,160,6,9.02088,3291,623,3385,0
396,3.81991,27,0,54,0,59.597,27,8189,54,0,140,4,6.69571,3345,627,3439,0
448,4.32148,34,0,2,0,67.564,34,8191,2,0,201,2,8.62531,3347,629,3441,0
483,4.65907,39,0,3,0,59.96,39,8191,3,0,198,3,9.47434,3350,632,3444,0
462,4.45628,44,0,2,0,75.005,44,8190,2,0,195,2,8.83757,3352,634,3446,0
466,4.49483,47,0,3,0,82.651,47,8189,3,0,172,3,9.96638,3355,637,3449,0
182,1.75559,8,0,52,0,65.305,8,8191,52,0,67,1,9.03053,3407,638,3501,0
331,3.19159,19,0,0,0,47.116,19,8191,0,0,165,0,7.07198,3407,638,3501,0
392,3.78101,28,0,0,0,48.014,28,8189,0,0,201,0,8.07538,3407,638,3501,0
410,3.95473,34,0,1,0,70.356,34,8189,1,0,207,1,8.43235,3408,639,3502,0
372,3.58803,22,0,36,0,50.603,22,8189,36,0,148,1,7.82453,3444,640,3538,0
403,3.88732,30,0,0,0,54.718,30,8189,0,0,207,0,12.0889,3444,640,3538,0
501,4.83244,37,0,1,0,54.445,37,8189,1,0,237,1,13.2853,3445,641,3539,0
321,3.09618,4,0,50,0,75.542,4,8191,50,0,137,1,12.8608,3495,642,3589,0
266,2.56591,17,0,0,0,40.543,17,8191,0,0,135,0,10.7672,3495,642,3589,0
436,4.20562,26,0,0,0,46.8,26,8191,0,0,217,0,8.21045,3495,642,3589,0
475,4.58205,34,0,0,0,63.711,34,8189,0,0,240,0,9.89885,3495,642,3589,0
438,4.22479,40,0,1,0,78.001,40,8191,1,0,206,1,8.53848,3496,643,3590,0
436,4.20543,44,0,3,0,120.158,44,8189,3,0,201,3,6.32909,3499,646,3593,0
447,4.31161,24,0,51,0,53.662,24,8191,51,0,170,3,6.7729,3550,649,3644,0
458,4.41647,32,0,0,0,54.051,32,8191,0,0,232,0,9.26208,3550,649,3644,0
378,3.64623,31,0,0,0,93.104,37,8189,0,0,194,0,10.6707,3550,649,3644,0
467,4.50442,42,0,3,0,54.967,42,8191,3,0,179,3,10.5935,3553,652,3647,0
436,4.20548,45,0,7,0,73.162,45,8158,7,0,147,7,8.96299,3560,659,3654,0
419,4.04151,24,0,49,0,42.586,24,8189,49,0,175,1,9.53222,3609,660,3703,0
426,4.10902,32,0,0,0,48.946,32,8189,0,0,215,0,12.5038,3609,660,3703,0
467,4.50445,38,0,40,0,72.558,2,8189,40,0,203,2,10.4874,3649,662,3743,0
329,3.17338,25,0,0,0,47.893,25,8189,0,0,160,0,8.74109,3649,662,3743,0
446,4.30193,33,0,0,0,62.962,33,8191,0,0,226,0,9.25243,3649,662,3743,0
479,4.6201,39,0,1,0,58.582,39,8189,1,0,229,1,9.78307,3650,663,3744,0
452,4.36012,43,0,4,0,78.644,43,8149,4,0,172,4,10.9408,3654,667,3748,0
490,4.72664,48,0,2,0,61.573,48,8189,2,0,210,2,11.5004,3656,669,3750,0
482,4.64948,51,0,4,0,72.706,51,8190,4,0,178,4,10.6321,3660,673,3754,0
393,3.7907,28,0,53,0,63.286,28,8191,53,0,138,1,8.6832,3713,674,3807,0
264,2.5465,18,0,29,0,45.784,18,8191,29,0,130,0,7.62192,3742,674,3836,0
324,3.12532,25,0,0,0,51.548,25,8189,0,0,165,0,6.67642,3742,674,3836,0
423,4.08001,33,0,0,0,56.602,33,8189,0,0,216,0,6.91762,3742,674,3836,0
428,4.12846,39,0,1,0,64.305,39,8189,1,0,207,1,7.9403,3743,675,3837,0
416,4.0123,3,0,45,0,71.076,3,8149,45,0,151,3,7.03339,3788,678,3882,0
350,3.37591,27,0,0,0,58.555,27,8189,0,0,170,0,6.68606,3788,678,3882,0
518,4.9964,35,0,0,0,58.56,35,8191,0,0,259,0,7.94995,3788,678,3882,0
513,4.94838,42,0,0,0,71.923,42,8189,0,0,258,0,7.87277,3788,678,3882,0
496,4.78465,46,0,3,0,82.269,46,8189,3,0,190,3,7.09128,3791,681,3885,0
477,4.60121,50,0,4,0,83.112,50,8189,4,0,172,4,7.93066,3795,685,3889,0
497,4.79403,53,0,4,0,92.285,53,8191,4,0,202,4,7.08163,3799,689,3893,0
480,4.63007,57,0,3,0,103.139,57,8191,3,0,192,3,7.04304,3802,692,3896,0
426,4.10888,59,0,6,0,99.098,59,8189,6,0,109,6,8.60602,3808,698,3902,0
518,4.99623,62,0,3,0,103.253,62,8189,3,0,179,3,9.05947,3811,701,3905,0
510,4.91957,64,0,3,0,96.964,65,8191,3,0,199,3,10.497,3814,704,3908,0
486,4.68804,58,0,5,0,107.633,67,8189,5,0,156,5,9.46469,3819,709,3913,0
488,4.70703,69,0,7,0,84.829,69,8189,7,0,143,7,9.61906,3826,716,3920,0
479,4.62037,71,0,6,0,130.516,71,8189,6,0,140,6,11.3075,3832,722,3926,0
452,4.35978,73,0,7,0,84.537,73,8191,7,0,106,7,10.6417,3839,729,3933,0
488,4.70713,75,0,5,0,102.464,75,8191,5,0,139,5,9.6287,3844,734,3938,0
489,4.71674,76,0,7,0,116.15,76,8189,7,0,125,7,11.4811,3851,741,3945,0
486,4.68761,66,0,3,0,100.206,78,8191,3,0,149,3,10.1015,3854,744,3948,0
485,4.67846,80,0,6,0,115.404,80,8191,6,0,125,6,9.29102,3860,750,3954,0
474,4.57215,79,0,9,0,110.352,81,8191,9,0,121,9,10.2172,3869,759,3963,0
491,4.736,69,0,10,0,103.895,83,8191,10,0,140,10,8.84722,3879,769,3973,0
468,4.51412,57,0,12,0,103.33,84,8191,12,0,102,12,8.6639,3891,781,3985,0
487,4.69786,60,0,8,0,117.353,85,8189,8,0,118,8,10.0436,3899,789,3993,0
531,5.1218,84,0,4,0,142.764,87,8191,4,0,151,4,10.5356,3903,793,3997,0
496,4.78415,80,0,11,0,133.474,89,8189,11,0,135,11,9.29102,3914,804,4008,0
462,4.45627,90,0,7,0,143.988,90,8191,7,0,90,7,9.12701,3921,811,4015,0
564,5.44031,85,0,6,0,129.135,91,8191,6,0,138,6,8.9437,3927,817,4021,0
319,3.07719,45,0,95,0,80.121,45,8189,62,0,93,4,11.4618,3989,821,4116,0
464,4.47586,49,0,3,0,85.412,49,8191,3,0,170,3,8.7025,3992,824,4119,0
371,3.57873,28,0,51,0,61.641,28,8189,51,0,154,2,6.83078,4043,826,4170,0
515,4.96728,35,0,1,0,69.574,35,8191,1,0,243,1,9.07877,4044,827,4171,0
463,4.46606,41,0,2,0,80.652,41,8191,2,0,206,2,8.38411,4046,829,4173,0
466,4.49481,45,0,3,0,66.383,45,8191,3,0,176,3,7.17811,4049,832,4176,0
324,3.12518,11,0,71,0,57.493,11,8191,71,0,105,2,8.23939,4120,834,4247,0
359,3.46281,22,0,0,0,47.658,22,8189,0,0,182,0,8.00784,4120,834,4247,0
405,3.90644,30,0,0,0,45.484,30,8189,0,0,206,0,9.24278,4120,834,4247,0
453,4.36943,36,0,1,0,67.138,36,8189,1,0,215,1,10.1979,4121,835,4248,0
416,4.01289,41,0,1,0,65.131,41,8189,1,0,209,1,11.0759,4122,836,4249,0
383,3.69435,26,0,41,0,52.995,26,8189,41,0,165,0,10.7961,4163,836,4290,0
509,4.90956,34,0,0,0,57.958,34,8191,0,0,260,0,8.37446,4163,836,4290,0
419,4.04153,39,0,2,0,69.888,39,8191,2,0,175,2,7.82453,4165,838,4292,0
439,4.2346,44,0,1,0,75.529,44,8191,1,0,204,1,8.01749,4166,839,4293,0
486,4.68767,48,0,2,0,95.166,48,8191,2,0,205,2,5.94317,4168,841,4295,0
477,4.60075,52,0,6,0,81.519,52,8189,6,0,193,6,6.48346,4174,847,4301,0
504,4.86155,53,0,5,0,80.871,55,8189,5,0,153,5,7.9403,4179,852,4306,0
563,5.43075,58,0,4,0,91.947,58,8189,4,0,202,4,7.94995,4183,856,4310,0
465,4.48547,61,0,7,0,89.464,61,8190,7,0,150,7,8.96299,4190,863,4317,0
448,4.32148,34,0,62,0,52.701,34,8189,62,0,184,1,10.3812,4252,864,4379,0
474,4.572,40,0,2,0,66.985,40,8189,2,0,224,2,11.8863,4254,866,4381,0
458,4.41757,45,0,3,0,85.495,45,8189,3,0,194,3,9.01123,4257,869,4384,0
327,3.15422,26,0,46,0,67.076,26,8190,46,0,134,1,7.9596,4303,870,4430,0
355,3.42419,32,0,0,0,55.166,32,8189,0,0,170,0,7.83418,4303,870,4430,0
453,4.36943,38,0,1,0,70.678,38,8189,1,0,214,1,8.89546,4304,871,4431,0
421,4.06074,43,0,2,0,89.987,43,8190,2,0,195,2,12.1661,4306,873,4433,0
511,4.92882,48,0,1,0,84.433,48,8189,1,0,218,1,7.63157,4307,874,4434,0
357,3.44351,25,0,52,0,55.171,25,8189,52,0,126,3,7.84382,4359,877,4486,0
269,2.59466,17,0,28,0,75.957,17,8189,28,0,132,0,8.35517,4387,877,4514,0
352,3.39521,25,0,0,0,46.5,25,8189,0,0,179,0,9.1656,4387,877,4514,0
475,4.58165,33,0,1,0,48.711,33,8191,1,0,231,1,7.18776,4388,878,4515,0
480,4.63008,39,0,1,0,66.015,39,8189,1,0,221,1,6.68606,4389,879,4516,0
469,4.52365,44,0,3,0,81.663,44,8189,3,0,217,3,8.64461,4392,882,4519,0
417,4.02237,26,0,46,0,73.652,26,8189,46,0,158,1,7.70875,4438,883,4565,0
538,5.18966,35,0,0,0,46.818,35,8191,0,0,271,0,7.00445,4438,883,4565,0
471,4.54305,41,0,1,0,65.141,41,8189,1,0,237,1,12.0118,4439,884,4566,0
490,4.7263,45,0,3,0,69.934,45,8189,3,0,188,3,11.8284,4442,887,4569,0
432,4.16685,25,0,48,0,42.787,25,8190,48,0,184,1,9.04018,4490,888,4617,0
426,4.10905,32,0,1,0,65.982,32,8189,1,0,216,1,8.9437,4491,889,4618,0
413,3.98393,37,0,1,0,61.346,37,8189,1,0,174,1,7.2553,4492,890,4619,0
455,4.38881,42,0,2,0,67.878,42,8189,2,0,197,2,5.90458,4494,892,4621,0
352,3.3952,23,0,45,0,59.384,23,8189,45,0,127,2,8.09467,4539,894,4666,0
491,4.73597,32,0,0,0,40.944,32,8189,0,0,244,0,6.86938,4539,894,4666,0
567,5.46936,39,0,1,0,63.954,39,8189,1,0,264,1,7.58333,4540,895,4667,0
483,4.65882,45,0,0,0,75.637,45,8189,0,0,243,0,8.37446,4540,895,4667,0
461,4.44659,27,0,47,0,45.546,27,8187,47,0,201,1,7.36142,4587,896,4714,0
437,4.21512,34,0,0,0,58.804,34,8189,0,0,222,0,8.58672,4587,896,4714,0
464,4.47555,39,0,2,0,72.235,39,8191,2,0,205,2,12.1854,4589,898,4716,0
329,3.17337,23,0,42,0,55.857,23,8189,42,0,121,2,12.4942,4631,900,4758,0
368,3.54942,30,0,0,0,72.7,30,8191,0,0,186,0,13.5168,4631,900,4758,0
402,3.87774,36,0,0,0,88.467,36,8191,0,0,204,0,11.1048,4631,900,4758,0
263,2.53694,20,0,38,0,47.774,20,8190,38,0,110,1,10.8733,4669,901,4796,0
444,4.28282,29,0,0,0,67.306,29,8189,0,0,225,0,9.59011,4669,901,4796,0
400,3.85843,35,0,0,0,72.131,35,8189,0,0,203,0,8.59637,4669,901,4796,0
479,4.62031,41,0,2,0,68.862,41,8189,2,0,207,2,6.54134,4671,903,4798,0
239,2.30529,23,0,42,0,72.363,23,8189,42,0,97,1,9.31032,4713,904,4840,0
426,4.109,31,0,0,0,93.746,31,8189,0,0,216,0,10.1015,4713,904,4840,0
349,3.36627,19,0,35,0,64.235,19,8191,35,0,155,1,11.9056,4748,905,4875,0
355,3.42417,26,0,0,0,69.022,26,8191,0,0,179,0,10.362,4748,905,4875,0
441,4.25371,34,0,0,0,68.08,34,8189,0,0,225,0,8.97264,4748,905,4875,0
421,4.06061,39,0,2,0,75.446,39,8189,2,0,180,2,9.49363,4750,907,4877,0
421,4.06077,3,0,45,0,88.102,3,8148,45,0,172,2,10.2944,4795,909,4922,0
321,3.09622,26,0,0,0,42.297,26,8189,0,0,158,0,7.76664,4795,909,4922,0
502,4.84213,35,0,0,0,52.923,35,8189,0,0,252,0,9.09806,4795,909,4922,0
393,3.79072,39,0,2,0,90.883,39,8191,2,0,167,2,8.73144,4797,911,4924,0
519,5.00625,45,0,1,0,66.551,45,8191,1,0,243,1,8.56742,4798,912,4925,0
462,4.45659,48,0,4,0,67.212,48,8191,4,0,151,4,9.04982,4802,916,4929,0
507,4.89056,52,0,3,0,86.375,52,8190,3,0,184,3,8.05608,4805,919,4932,0
365,3.52079,54,0,3,0,91.332,54,8189,3,0,134,3,9.1463,4808,922,4935,0
515,4.96764,57,0,4,0,93.44,57,8189,4,0,179,4,8.60602,4812,926,4939,0
500,4.82275,59,0,6,0,95.227,60,8189,6,0,143,6,9.70589,4818,932,4945,0
491,4.73592,63,0,3,0,110.368,63,8189,3,0,217,3,9.75413,4821,935,4948,0
510,4.91921,58,0,2,0,91.101,66,8191,2,0,202,2,7.37107,4823,937,4950,0
432,4.16689,34,0,71,0,60.862,34,8189,71,0,136,4,7.24565,4894,941,5021,0
500,4.82279,41,0,0,0,66.539,41,8191,0,0,254,0,8.2008,4894,941,5021,0
458,4.4176,45,0,3,0,64.955,45,8191,3,0,175,3,12.938,4897,944,5024,0
468,4.51423,8,0,51,0,78.298,8,8189,51,0,190,2,11.2978,4948,946,5075,0
462,4.45625,31,0,0,0,49.991,31,8189,0,0,225,0,9.11736,4948,946,5075,0
433,4.17652,37,0,2,0,64.94,37,8191,2,0,202,2,9.1849,4950,948,5077,0
434,4.18615,9,0,42,0,79.736,9,8191,42,0,183,1,7.82453,4992,949,5119,0
272,2.62359,25,0,0,0,103.994,25,8189,0,0,134,0,8.02714,4992,949,5119,0
445,4.29238,33,0,0,0,67.532,33,8191,0,0,226,0,7.4965,4992,949,5119,0
476,4.59135,39,0,1,0,78.35,39,8191,1,0,229,1,7.14917,4993,950,5120,0
527,5.08354,45,0,1,0,68.402,45,8189,1,0,248,1,6.63782,4994,951,5121,0
480,4.63009,49,0,6,0,88.983,49,8189,6,0,197,6,6.36768,5000,957,5127,0
491,4.73644,52,0,5,0,86.35,52,8189,5,0,153,5,6.62818,5005,962,5132,0
425,4.09972,55,0,3,0,100.592,55,8189,3,0,139,3,7.78594,5008,965,5135,0
541,5.21826,58,0,2,0,98.44,58,8189,2,0,221,2,11.1338,5010,967,5137,0
443,4.27298,61,0,4,0,94.908,61,8189,4,0,138,4,10.5549,5014,971,5141,0
515,4.96747,63,0,4,0,77.925,63,8191,4,0,146,4,8.58672,5018,975,5145,0
415,4.00294,34,0,65,0,60.044,34,8189,62,0,170,1,9.29102,5080,976,5210,0
522,5.03498,41,0,0,0,78.665,41,8191,0,0,263,0,9.85061,5080,976,5210,0
420,4.05115,15,0,47,0,59.355,15,8191,47,0,144,3,9.8892,5127,979,5257,0
459,4.42732,30,0,0,0,46.758,30,8189,0,0,228,0,9.49363,5127,979,5257,0
517,4.98676,37,0,1,0,63.998,37,8189,1,0,248,1,7.36142,5128,980,5258,0
465,4.48516,43,0,1,0,99.267,43,8191,1,0,216,1,6.44486,5129,981,5259,0
374,3.60744,23,0,47,0,56.808,23,8189,47,0,155,1,6.69571,5176,982,5306,0
408,3.93539,30,0,0,0,64.161,30,8189,0,0,208,0,7.70875,5176,982,5306,0
453,4.36945,37,0,0,0,56.468,37,8189,0,0,228,0,13.2853,5176,982,5306,0
509,4.90972,43,0,1,0,64.578,43,8187,1,0,237,1,12.0118,5177,983,5307,0
500,4.82314,47,0,3,0,78.599,47,8189,3,0,194,3,11.3943,5180,986,5310,0
494,4.76481,51,0,3,0,95.038,51,8191,3,0,202,3,8.61566,5183,989,5313,0
479,4.62033,50,0,4,0,113.644,54,8189,4,0,170,4,8.82792,5187,993,5317,0
301,2.90327,29,0,57,0,49.341,29,8189,57,0,112,2,8.95334,5244,995,5374,0
422,4.07077,36,0,0,0,62.238,36,8190,0,0,218,0,9.57082,5244,995,5374,0
493,4.75533,41,0,3,0,62.871,41,8189,3,0,211,3,8.74109,5247,998,5377,0
134,1.29253,9,0,45,0,43.229,9,8189,45,0,46,0,8.30693,5292,998,5422,0
203,1.95798,13,0,11,0,33.798,13,8189,11,0,101,0,8.19115,5303,998,5433,0
340,3.27948,23,0,0,0,57.858,23,8191,0,0,172,0,8.54813,5303,998,5433,0
458,4.41768,31,0,1,0,47.911,31,8191,1,0,218,1,8.97264,5304,999,5434,0
436,4.20555,37,0,1,0,67.707,37,8189,1,0,207,1,8.80862,5305,1000,5435,0
471,4.54306,3,0,44,0,75.195,3,8150,44,0,200,2,8.01749,5349,1002,5479,0
381,3.67509,27,0,0,0,55.393,27,8191,0,0,186,0,8.24904,5349,1002,5479,0
410,3.95449,34,0,1,0,77.137,34,8189,1,0,194,1,9.36821,5350,1003,5480,0
479,4.62035,40,0,2,0,65.466,40,8190,2,0,224,2,8.88581,5352,1005,5482,0
344,3.31808,25,0,40,0,51.215,25,8191,40,0,149,0,10.6417,5392,1005,5522,0
409,3.9452,32,0,0,0,63.4,32,8191,0,0,208,0,8.96299,5392,1005,5522,0
467,4.5047,4,0,40,0,69.467,4,8191,40,0,202,2,9.6673,5432,1007,5562,0
282,2.71862,23,0,0,0,46.613,24,8189,0,0,139,0,11.9056,5432,1007,5562,0
372,3.58466,31,0,0,0,66.951,31,8189,0,0,188,0,11.4908,5432,1007,5562,0
434,4.18618,37,0,1,0,81.198,37,8189,1,0,208,1,11.8863,5433,1008,5563,0
231,2.22812,9,0,42,0,33.297,9,8189,42,0,95,1,11.0373,5475,1009,5605,0
299,2.884,19,0,0,0,36.166,19,8191,0,0,154,0,9.8892,5475,1009,5605,0
377,3.63638,27,0,0,0,54.396,27,8189,0,0,193,0,10.3427,5475,1009,5605,0
491,4.73583,35,0,1,0,46.076,35,8191,1,0,235,1,9.70589,5476,1010,5606,0
369,3.55917,20,0,39,0,89.594,20,8191,39,0,161,1,10.4874,5515,1011,5645,0
386,3.7232,28,0,0,0,53.746,28,8189,0,0,195,0,8.27798,5515,1011,5645,0
445,4.29257,35,0,1,0,60.899,35,8189,1,0,214,1,8.76038,5516,1012,5646,0
483,4.6593,40,0,2,0,69.893,40,8189,2,0,210,2,10.3716,5518,1014,5648,0
484,4.66844,45,0,1,0,70.519,45,8189,1,0,227,1,9.04018,5519,1015,5649,0
543,5.23751,51,0,2,0,87.763,51,8190,2,0,250,2,9.04982,5521,1017,5651,0
524,5.05458,54,0,3,0,82.467,54,8189,3,0,169,3,10.5356,5524,1020,5654,0
502,4.84214,57,0,5,0,77.029,57,8191,5,0,169,5,9.55152,5529,1025,5659,0
377,3.6364,31,0,58,0,47.269,31,8189,58,0,151,1,9.55152,5587,1026,5717,0
448,4.32125,37,0,0,0,55.817,37,8189,0,0,226,0,10.4005,5587,1026,5717,0
418,4.03189,42,0,3,0,85.013,42,8189,3,0,170,3,10.005,5590,1029,5720,0
419,4.04185,46,0,2,0,74.268,46,8191,2,0,172,2,8.96299,5592,1031,5722,0
441,4.25374,49,0,3,0,98.607,49,8191,3,0,179,3,8.23939,5595,1034,5725,0
442,4.26335,52,0,6,0,110.899,52,8191,6,0,151,6,7.59298,5601,1040,5731,0
476,4.59141,55,0,5,0,79.844,55,8191,5,0,164,5,10.4584,5606,1045,5736,0
391,3.77143,31,0,58,0,51.51,31,8189,58,0,160,3,9.82166,5664,1048,5794,0
489,4.71681,38,0,0,0,75.903,38,8189,0,0,249,0,8.96299,5664,1048,5794,0
469,4.52399,43,0,4,0,67.05,43,8189,4,0,182,4,8.16221,5668,1052,5798,0
374,3.60756,24,0,45,0,40.951,24,8191,45,0,161,1,8.21045,5713,1053,5843,0
452,4.35971,32,0,1,0,48.435,32,8189,1,0,214,1,8.80862,5714,1054,5844,0
476,4.5913,38,0,2,0,63.561,38,8154,2,0,206,2,10.5453,5716,1056,5846,0
466,4.49514,43,0,2,0,75.872,43,8189,2,0,200,2,10.2751,5718,1058,5848,0
457,4.40805,47,0,2,0,68.942,47,8189,2,0,188,2,10.2462,5720,1060,5850,0
455,4.38881,51,0,0,0,100.233,51,8189,0,0,233,0,10.9987,5720,1060,5850,0
427,4.11866,29,0,54,0,45.188,29,8189,54,0,170,2,9.75413,5774,1062,5904,0
372,3.58826,35,0,1,0,96.213,35,8189,1,0,176,1,8.73144,5775,1063,5905,0
437,4.21538,41,0,0,0,121.038,41,8189,0,0,223,0,11.182,5775,1063,5905,0
303,2.92276,21,0,44,0,42.75,21,8189,44,0,123,1,11.8574,5819,1064,5949,0
468,4.51428,30,0,0,0,50.895,30,8189,0,0,237,0,12.4073,5819,1064,5949,0
466,4.49481,37,0,1,0,56.799,37,8189,1,0,221,1,10.8733,5820,1065,5950,0
438,4.22502,42,0,3,0,64.057,42,8189,3,0,187,3,9.69624,5823,1068,5953,0
479,4.62031,46,0,3,0,87.178,46,8189,3,0,206,3,11.0952,5826,1071,5956,0
473,4.56167,49,0,4,0,79.911,49,8190,4,0,151,4,11.6741,5830,1075,5960,0
471,4.54307,53,0,3,0,91.222,53,8190,3,0,172,3,10.69,5833,1078,5963,0
543,5.23792,56,0,3,0,79.182,56,8191,3,0,172,3,11.6741,5836,1081,5966,0
450,4.34057,59,0,6,0,84.251,59,8190,6,0,174,6,13.3914,5842,1087,5972,0
587,5.66192,58,0,6,0,97.499,62,8157,6,0,181,6,11.5101,5848,1093,5978,0
351,3.38557,33,0,65,0,54.115,33,8190,65,0,131,3,10.3041,5913,1096,6043,0
439,4.23462,38,0,1,0,63.508,38,8189,1,0,194,1,9.78307,5914,1097,6044,0
475,4.58192,43,0,1,0,72.712,43,8189,1,0,222,1,9.73483,5915,1098,6045,0
488,4.70707,48,0,2,0,95.844,48,8189,2,0,205,2,9.57082,5917,1100,6047,0
524,5.05436,52,0,2,0,74.665,52,8189,2,0,220,2,10.4874,5919,1102,6049,0
575,5.54617,56,0,5,0,79.901,56,8191,5,0,191,5,13.2756,5924,1107,6054,0
478,4.61071,59,0,4,0,93.846,59,8191,4,0,201,4,11.1338,5928,1111,6058,0
376,3.62669,32,0,61,0,56.878,32,8189,61,0,137,1,9.20419,5989,1112,6119,0
471,4.54335,38,0,1,0,71.17,38,8189,1,0,219,1,8.53848,5990,1113,6120,0
445,4.29231,12,0,44,0,67.779,12,8191,44,0,180,2,9.35856,6034,1115,6164,0
366,3.53023,28,0,0,0,84.515,28,8191,0,0,182,0,9.87955,6034,1115,6164,0
431,4.15723,35,0,0,0,73.225,35,8191,0,0,220,0,9.10771,6034,1115,6164,0
414,3.99334,40,0,1,0,76.851,40,8191,1,0,192,1,8.89546,6035,1116,6165,0
482,4.64918,45,0,1,0,90.004,45,8189,1,0,224,1,8.84722,6036,1117,6166,0
453,4.36926,48,0,5,0,93.647,48,8191,5,0,164,5,9.1849,6041,1122,6171,0
347,3.34681,25,0,54,0,72.54,25,8189,54,0,116,4,8.69285,6095,1126,6225,0
452,4.36,33,0,0,0,47.988,33,8191,0,0,231,0,9.41645,6095,1126,6225,0
449,4.33116,39,0,0,0,85.157,39,8189,0,0,229,0,11.4715,6095,1126,6225,0
422,4.07058,43,0,4,0,73.931,43,8191,4,0,157,4,11.5872,6099,1130,6229,0
502,4.84211,8,0,50,0,74.189,8,8189,50,0,186,3,10.5356,6149,1133,6279,0
402,3.87754,29,0,0,0,55.177,29,8191,0,0,196,0,8.55778,6149,1133,6279,0
466,4.49493,36,0,1,0,71.483,36,8189,1,0,235,1,9.60941,6150,1134,6280,0
465,4.48514,42,0,0,0,95.982,42,8189,0,0,219,0,10.3909,6150,1134,6280,0
474,4.572,46,0,3,0,84.315,46,8189,3,0,198,3,11.7609,6153,1137,6283,0
464,4.47546,20,0,52,0,102.579,20,8191,52,0,224,1,10.0339,6205,1138,6335,0
360,3.47251,31,0,0,0,58.955,31,8189,0,0,174,0,9.85061,6205,1138,6335,0
504,4.86143,38,0,0,0,58.538,38,8191,0,0,256,0,11.3364,6205,1138,6335,0
439,4.23438,42,0,4,0,75.578,42,8191,4,0,149,4,7.94995,6209,1142,6339,0
439,4.23441,46,0,3,0,77.987,46,8191,3,0,181,3,8.64461,6212,1145,6342,0
434,4.18619,49,0,4,0,78.733,49,8189,4,0,157,4,9.02088,6216,1149,6346,0
395,3.81002,28,0,51,0,55.698,28,8189,51,0,139,1,9.59976,6267,1150,6397,0
514,4.95816,36,0,0,0,58.266,36,8189,0,0,257,0,10.8251,6267,1150,6397,0
453,4.36964,41,0,1,0,81.239,41,8189,1,0,213,1,10.1593,6268,1151,6398,0
352,3.39536,25,0,42,0,52.243,25,8189,42,0,150,1,9.59011,6310,1152,6440,0
456,4.39863,33,0,0,0,54.642,33,8189,0,0,231,0,9.59976,6310,1152,6440,0
489,4.71698,39,0,1,0,71.022,39,8189,1,0,231,1,8.00784,6311,1153,6441,0
298,2.87449,23,0,40,0,73.068,23,8189,40,0,124,1,9.52258,6351,1154,6481,0
428,4.12853,31,0,0,0,68.644,31,8191,0,0,219,0,6.7536,6351,1154,6481,0
413,3.98397,28,0,1,0,65.639,37,8189,1,0,197,1,7.90171,6352,1155,6482,0
472,4.55282,42,0,3,0,59.016,42,8191,3,0,185,3,8.2201,6355,1158,6485,0
518,4.99635,47,0,2,0,73.045,47,8189,2,0,240,2,7.61227,6357,1160,6487,0
203,1.95804,12,0,55,0,33.924,12,8189,55,0,79,0,8.24904,6412,1160,6542,0
310,2.99014,21,0,0,0,54.489,21,8189,0,0,157,0,8.39376,6412,1160,6542,0
238,2.29566,26,0,0,0,45.868,26,8189,0,0,120,0,9.89885,6412,1160,6542,0
363,3.50145,32,0,0,0,60.445,32,8191,0,0,186,0,9.1656,6412,1160,6542,0
528,5.0927,39,0,3,0,45.633,39,8191,3,0,218,3,11.346,6415,1163,6545,0
402,3.8775,42,0,3,0,90.129,42,8189,3,0,153,3,10.2944,6418,1166,6548,0
408,3.9354,46,0,4,0,96.539,46,8189,4,0,145,4,9.8892,6422,1170,6552,0
431,4.15735,49,0,3,0,73.782,49,8189,3,0,154,3,10.0532,6425,1173,6555,0
465,4.4855,52,0,4,0,99.927,52,8189,4,0,170,4,12.1082,6429,1177,6559,0
404,3.89693,55,0,5,0,85.705,55,8191,5,0,132,5,9.02088,6434,1182,6564,0
442,4.26369,57,0,4,0,108.585,57,8190,4,0,151,4,9.8699,6438,1186,6568,0
452,4.36005,60,0,9,0,75.492,60,8190,9,0,143,9,10.2076,6447,1195,6577,0
538,5.18927,62,0,5,0,102.725,62,8189,5,0,156,5,9.81202,6452,1200,6582,0
433,4.17658,64,0,6,0,118.524,64,8190,6,0,130,6,10.1015,6458,1206,6588,0
458,4.41769,4,0,71,0,61.955,4,8181,71,0,111,6,11.8092,6529,1212,6659,0
506,4.88101,38,0,0,0,69.887,38,8189,0,0,243,0,11.7609,6529,1212,6659,0
471,4.54295,43,0,4,0,66.618,43,8191,4,0,171,4,10.4874,6533,1216,6663,0
497,4.79389,47,0,2,0,76.606,47,8191,2,0,207,2,10.3137,6535,1218,6665,0
321,3.09624,25,0,50,0,54.374,25,8191,50,0,108,2,10.2751,6585,1220,6715,0
417,4.02222,32,0,1,0,87.566,32,8159,1,0,196,1,10.1015,6586,1221,6716,0
387,3.73283,38,0,0,0,70.276,38,8191,0,0,196,0,9.76378,6586,1221,6716,0
451,4.35016,42,0,3,0,77.407,42,8149,3,0,173,3,8.9244,6589,1224,6719,0
443,4.27297,46,0,3,0,82.145,46,8189,3,0,184,3,9.31997,6592,1227,6722,0
397,3.82928,28,0,46,0,50.376,28,8189,46,0,169,0,10.7768,6638,1227,6768,0
460,4.43672,35,0,0,0,71.895,35,8191,0,0,230,0,13.4783,6638,1227,6768,0
414,3.99318,40,0,3,0,69.953,40,8189,3,0,172,3,12.7161,6641,1230,6771,0
430,4.1478,44,0,1,0,74.497,44,8189,1,0,176,1,11.8863,6642,1231,6772,0
275,2.65267,24,0,46,0,78.913,24,8191,46,0,108,1,10.3234,6688,1232,6818,0
462,4.45652,32,0,0,0,62.384,32,8189,0,0,231,0,9.70589,6688,1232,6818,0
416,4.01278,38,0,0,0,72.257,38,8189,0,0,212,0,10.14,6688,1232,6818,0
586,5.65257,45,0,1,0,68.714,45,8191,1,0,296,1,10.8926,6689,1233,6819,0
301,2.90333,26,0,46,0,62.169,26,8190,46,0,122,1,8.52883,6735,1234,6865,0
482,4.64923,34,0,0,0,47.004,34,8191,0,0,247,0,7.62192,6735,1234,6865,0
437,4.21511,39,0,1,0,86.294,39,8191,1,0,206,1,7.90171,6736,1235,6866,0
282,2.72002,22,0,42,0,50.078,22,8189,42,0,100,2,8.4613,6778,1237,6908,0
333,3.21199,28,0,0,0,60.865,28,8189,0,0,171,0,8.88581,6778,1237,6908,0
386,3.72326,34,0,0,0,72.753,34,8189,0,0,196,0,7.50614,6778,1237,6908,0
464,4.47552,39,0,4,0,65.15,39,8189,4,0,165,4,6.74395,6782,1241,6912,0
471,4.54317,43,0,3,0,68.252,43,8189,3,0,183,3,7.94995,6785,1244,6915,0
481,4.63954,47,0,4,0,84.703,47,8189,4,0,182,4,7.86312,6789,1248,6919,0
451,4.35014,51,0,3,0,81.614,51,8189,3,0,160,3,8.6639,6792,1251,6922,0
421,4.06077,53,0,5,0,83.589,53,8191,5,0,145,5,10.6803,6797,1256,6927,0
551,5.31457,57,0,4,0,63.383,57,8189,4,0,194,4,11.6258,6801,1260,6931,0
408,3.93548,59,0,7,0,84.304,59,8189,7,0,125,7,11.0277,6808,1267,6938,0
516,4.97743,62,0,8,0,98.929,62,8189,8,0,174,8,8.11397,6816,1275,6946,0
525,5.0644,59,0,3,0,91.392,64,8191,3,0,153,3,8.00784,6819,1278,6949,0
459,4.42733,66,0,8,0,109.608,66,8190,8,0,132,8,7.59298,6827,1286,6957,0
490,4.72628,66,0,5,0,112.572,68,8189,5,0,119,5,8.83757,6832,1291,6962,0


