SendPacket,SendRate(Mb/s),FlightSize,ReceiveRate(Mb/s),Send Loss,Recv Loss,RTT(ms),CWnd,FlowWindow,Retrans,PktSndPeriod(us),RecvACK,RecvNAK,EstimatedBandwidth(Mb/s),Retrans_Total,NAK_TotalRecv,Total Send Loss,Total Recv Loss
407,4.39832,60,0,2,0,97.919,84,8189,2,0,124,2,11.0423,2,2,2,0
356,4.14554,60,0,89,0,91.761,62,8189,62,0,79,3,10.5531,64,5,91,0
318,3.70306,32,0,79,0,57.367,32,8191,62,0,58,4,9.30675,126,9,170,0
425,4.94893,80,0,8,0,117.038,80,8160,8,0,122,8,7.48966,134,17,178,0
278,3.23722,33,0,91,0,48.799,33,8189,68,0,35,9,6.19674,202,26,269,0
355,4.13389,27,0,50,0,44.433,27,8189,50,0,138,1,5.31149,252,27,319,0
417,4.85584,33,0,4,0,61.664,33,8158,4,0,167,4,6.12685,256,31,323,0
442,5.14696,47,0,3,0,66.667,47,8189,3,0,184,3,8.01382,259,34,326,0
304,3.54,27,0,53,0,67.187,27,8189,53,0,118,4,7.74592,312,38,379,0
345,4.01742,21,0,27,0,45.089,21,8189,27,0,156,0,8.25843,339,38,406,0
451,5.25186,29,0,1,0,48.334,29,8189,1,0,217,1,8.20019,340,39,407,0
355,4.13416,22,0,31,0,40.193,22,8190,31,0,161,1,9.95904,371,40,438,0
416,4.84423,3,0,30,0,60.213,3,8162,30,0,196,1,9.53971,401,41,468,0
384,4.47184,23,0,0,0,45.927,23,8189,0,0,190,0,9.10874,401,41,468,0
292,3.40035,13,0,28,0,59.784,13,8189,28,0,128,1,8.57293,429,42,496,0
410,4.7744,24,0,0,0,41.428,24,8189,0,0,207,0,9.19027,429,42,496,0
463,5.39168,32,0,1,0,55.351,32,8189,1,0,221,1,9.3184,430,43,497,0
302,3.51658,21,0,33,0,47.76,21,8187,33,0,132,1,9.73773,463,44,530,0
356,4.14571,28,0,1,0,72.43,28,8189,1,0,179,1,9.50477,464,45,531,0
431,5.0189,34,0,2,0,65.773,34,8189,2,0,189,2,8.7127,466,47,533,0
443,5.15864,67,0,5,0,75.572,67,8189,5,0,176,5,9.07379,471,52,538,0
461,5.36814,68,0,8,0,152.698,99,8145,8,0,83,8,8.86413,479,60,546,0
485,5.64768,111,0,19,0,132.722,114,8177,19,0,49,19,9.48147,498,79,565,0
427,4.97232,122,0,47,0,105.649,122,8188,47,0,30,46,8.99226,545,125,612,0
418,4.86736,68,0,126,0,89.454,75,8189,101,0,102,4,9.83091,646,129,738,0
370,4.30853,3,0,113,0,141.791,3,8088,69,0,79,10,9.52806,715,139,851,0
345,4.01745,77,0,4,0,110.213,77,8167,4,0,105,4,10.425,719,143,855,0
500,5.82184,99,0,14,0,133.448,99,8191,14,0,61,14,10.0173,733,157,869,0
322,3.74977,107,0,37,0,122.457,107,8191,37,0,28,37,8.53798,770,194,906,0
447,5.20566,81,0,112,0,110.962,81,8191,104,0,117,5,6.46464,874,199,1018,0
267,3.10907,4,0,105,0,120.886,4,8191,70,0,34,12,5.40467,944,211,1123,0
382,4.44806,4,0,69,0,94.936,4,8170,69,0,83,4,8.21184,1013,215,1192,0
319,3.7147,19,0,34,0,50.99,19,8191,34,0,125,1,7.58285,1047,216,1226,0
390,4.5413,27,0,1,0,58.913,27,8189,1,0,186,1,6.95386,1048,217,1227,0
188,2.1892,10,0,32,0,40.919,10,8191,32,0,79,1,5.824,1080,218,1259,0
338,3.93594,21,0,0,0,43.543,21,8189,0,0,172,0,6.39475,1080,218,1259,0
419,4.87917,29,0,1,0,41.829,29,8191,1,0,198,1,7.92064,1081,219,1260,0
364,4.23871,33,0,3,0,56.632,33,8189,3,0,143,3,8.63117,1084,222,1263,0
437,5.08874,52,0,2,0,75.254,52,8191,2,0,179,2,8.10701,1086,224,1265,0
485,5.6476,64,0,10,0,96.146,94,8189,10,0,97,10,7.68768,1096,234,1275,0
307,3.57492,11,0,117,0,89.788,11,8191,75,0,31,16,7.15187,1171,250,1392,0
419,4.87932,83,0,13,0,130.416,83,8190,13,0,114,13,5.87059,1184,263,1405,0
455,5.29876,86,0,12,0,130.583,99,8191,12,0,45,12,7.62944,1196,275,1417,0
276,3.21413,49,0,112,0,58.874,49,8191,71,0,55,12,8.50304,1267,287,1529,0
453,5.27519,84,0,20,0,92.252,84,8191,20,0,74,20,8.03712,1287,307,1549,0
234,2.72483,13,0,87,0,32.78,13,8189,63,0,86,0,6.89562,1350,307,1636,0
405,4.71578,24,0,0,0,38.417,24,8189,0,0,204,0,8.63117,1350,307,1636,0
385,4.48338,30,0,1,0,92.374,30,8191,1,0,184,1,8.4448,1351,308,1637,0
432,5.03064,35,0,5,0,54.441,35,8189,5,0,158,5,10.6812,1356,313,1642,0
418,4.8675,68,0,3,0,108.261,71,8189,3,0,143,3,11.1588,1359,316,1645,0
263,3.06263,15,0,91,0,90.779,15,8191,64,0,51,5,12.7895,1423,321,1736,0
438,5.10025,66,0,5,0,110.745,72,8189,5,0,83,5,10.588,1428,326,1741,0
459,5.34488,93,0,7,0,179.008,107,8191,7,0,99,7,8.23514,1435,333,1748,0
271,3.15572,3,0,127,0,145.631,3,8081,77,0,9,17,7.5712,1512,350,1875,0
391,4.55311,80,0,5,0,115.623,80,8189,5,0,114,5,9.06214,1517,355,1880,0
372,4.33174,47,0,94,0,60.447,47,8189,63,0,76,4,7.5712,1580,359,1974,0
365,4.25046,30,0,54,0,60.629,30,8191,54,0,146,2,8.49139,1634,361,2028,0
436,5.07735,35,0,3,0,67.889,35,8189,3,0,175,3,8.52634,1637,364,2031,0
301,3.5052,18,0,40,0,53.731,18,8189,40,0,92,3,9.6329,1677,367,2071,0
410,4.7744,26,0,1,0,58.313,26,8189,1,0,194,1,9.30675,1678,368,2072,0
375,4.36674,32,0,2,0,65.015,32,8189,2,0,176,2,9.6329,1680,370,2074,0
381,4.4366,36,0,41,0,68.329,2,8191,41,0,129,5,8.72435,1721,375,2115,0
383,4.45979,25,0,0,0,44.078,25,8191,0,0,188,0,7.78086,1721,375,2115,0
438,5.10022,32,0,2,0,56.692,32,8189,2,0,205,2,8.52634,1723,377,2117,0
324,3.77289,10,0,38,0,86.677,10,8191,38,0,132,2,7.8391,1761,379,2155,0
448,5.21685,27,0,0,0,53.227,27,8189,0,0,221,0,8.4448,1761,379,2155,0
422,4.91408,33,0,1,0,64.985,33,8189,1,0,200,1,8.43315,1762,380,2156,0
379,4.41346,4,0,41,0,78.796,4,8190,41,0,129,4,8.95731,1803,384,2197,0
386,4.495,26,0,0,0,48.985,26,8190,0,0,190,0,8.4681,1803,384,2197,0
308,3.58657,18,0,28,0,44.564,18,8189,28,0,138,1,8.35162,1831,385,2225,0
398,4.63469,27,0,2,0,56.309,27,8191,2,0,188,2,8.29338,1833,387,2227,0
366,4.26232,32,0,3,0,63.271,32,8190,3,0,148,3,8.08371,1836,390,2230,0
438,5.1008,37,0,2,0,74.096,37,8191,2,0,176,2,10.0639,1838,392,2232,0
430,5.00731,81,0,8,0,94.059,85,8189,8,0,121,8,11.3568,1846,400,2240,0
382,4.4484,98,0,19,0,126.7,98,8191,19,0,38,19,11.5432,1865,419,2259,0
276,3.21379,56,0,100,0,88.056,56,8191,61,0,63,2,10.3085,1926,421,2359,0
522,6.07798,98,0,11,0,93.164,102,8173,11,0,114,11,8.64282,1937,432,2370,0
269,3.13245,48,0,111,0,60.363,48,8191,67,0,52,8,8.53798,2004,440,2481,0
425,4.94896,87,0,10,0,127.016,87,8190,10,0,82,10,9.0272,2014,450,2491,0
465,5.41478,103,0,26,0,117.067,103,8184,26,0,48,26,10.2386,2040,476,2517,0
287,3.34218,12,0,152,0,67.237,12,8189,133,0,57,3,10.4366,2173,479,2669,0
406,4.72774,29,0,1,0,51.651,29,8189,1,0,188,1,10.0056,2174,480,2670,0
411,4.786,34,0,4,0,70.478,34,8157,4,0,149,4,8.64282,2178,484,2674,0
419,4.8792,54,0,3,0,69.04,54,8191,3,0,155,3,9.22522,2181,487,2677,0
403,4.69314,92,0,10,0,95.658,92,8189,10,0,88,10,7.60614,2191,497,2687,0
279,3.24889,55,0,96,0,59.11,55,8189,62,0,63,3,9.27181,2253,500,2783,0
353,4.11093,29,0,57,0,52.032,30,8190,57,0,127,2,10.0872,2310,502,2840,0
432,5.03065,35,0,5,0,59.226,35,8191,5,0,174,5,11.2054,2315,507,2845,0
417,4.85546,67,0,6,0,109.934,67,8186,6,0,131,6,10.0406,2321,513,2851,0
307,3.57495,52,0,85,0,63.324,52,8189,65,0,85,6,8.27008,2386,519,2936,0
351,4.08755,33,0,71,0,61.111,33,8191,63,0,85,4,8.35162,2449,523,3007,0
393,4.57652,37,0,3,0,79.602,37,8190,3,0,150,3,8.65446,2452,526,3010,0
420,4.89079,70,0,6,0,147.909,88,8189,6,0,100,6,9.09709,2458,532,3016,0
464,5.40298,101,0,25,0,118.64,102,8191,25,0,42,25,8.1303,2483,557,3041,0
303,3.52853,32,0,134,0,115.033,5,8147,134,0,22,24,7.26835,2617,581,3175,0
376,4.37848,62,0,11,0,126.211,74,8165,11,0,97,11,6.68595,2628,592,3186,0
270,3.14404,9,0,93,0,104.383,9,8191,74,0,16,15,6.63936,2702,607,3279,0
417,4.85553,80,0,11,0,137.828,80,8191,11,0,107,11,6.95386,2713,618,3290,0
325,3.78453,60,0,84,0,89.007,63,8189,73,0,76,4,7.45472,2786,622,3374,0
437,5.0886,82,0,10,0,109.579,88,8190,10,0,59,10,8.736,2796,632,3384,0
342,3.98262,62,0,93,0,92.002,63,8191,65,0,77,5,8.43315,2861,637,3477,0
380,4.42527,59,0,6,0,195.865,96,8189,6,0,81,6,6.52288,2867,643,3483,0
516,6.00908,105,0,27,0,117.693,105,8191,27,0,30,27,6.84902,2894,670,3510,0
346,4.02927,4,0,136,0,105.555,4,8191,113,0,15,27,7.72262,3007,697,3646,0
392,4.56476,66,0,5,0,98.501,82,8189,5,0,118,5,10.0872,3012,702,3651,0
331,3.85434,3,0,103,0,154.838,3,8191,71,0,25,12,10.4366,3083,714,3754,0
428,4.98391,77,0,4,0,120.934,81,8189,4,0,117,4,10.2619,3087,718,3758,0
296,3.44683,4,0,100,0,126.337,4,8189,68,0,29,9,9.85421,3155,727,3858,0
366,4.26197,30,0,62,0,52.148,30,8189,59,0,116,1,9.3417,3214,728,3920,0
381,4.43663,35,0,2,0,66.293,35,8157,2,0,163,2,9.19027,3216,730,3922,0
414,4.82122,69,0,4,0,94.68,72,8191,4,0,152,4,9.94739,3220,734,3926,0
384,4.47137,88,0,25,0,113.756,88,8184,25,0,40,25,10.0173,3245,759,3951,0
285,3.31874,57,0,89,0,86.483,68,8189,60,0,87,1,10.6463,3305,760,4040,0
413,4.80891,86,0,26,0,113.977,86,8191,26,0,42,25,9.76102,3331,785,4066,0
342,3.98243,53,0,90,0,83.688,68,8189,65,0,88,4,7.50131,3396,789,4156,0
441,5.1357,65,0,9,0,136.354,100,8190,9,0,85,9,6.39475,3405,798,4165,0
341,3.97113,43,0,113,0,54.982,43,8191,113,0,47,11,6.62771,3518,809,4278,0
408,4.75141,71,0,9,0,123.142,91,8191,9,0,100,9,7.10528,3527,818,4287,0
275,3.20237,23,0,105,0,62.471,23,8191,70,0,29,12,7.55955,3597,830,4392,0
399,4.64632,29,0,61,0,56.129,29,8191,61,0,123,4,7.5712,3658,834,4453,0
389,4.52983,34,0,7,0,60.826,34,8191,7,0,146,7,8.00218,3665,841,4460,0
508,5.91559,70,0,4,0,115.646,73,8191,4,0,193,4,7.51296,3669,845,4464,0
243,2.8298,11,0,88,0,117.116,11,8189,74,0,36,4,8.43315,3743,849,4552,0
518,6.03234,57,0,6,0,105.305,86,8189,6,0,120,6,9.12038,3749,855,4558,0
307,3.57497,15,0,105,0,77.606,15,8191,65,0,51,6,8.4448,3814,861,4663,0
466,5.42656,87,0,8,0,137.098,87,8161,8,0,119,8,7.61779,3822,869,4671,0
447,5.20523,103,0,15,0,111.622,103,8191,15,0,47,15,7.09363,3837,884,4686,0
119,1.38573,7,0,108,0,44.972,7,8191,63,0,27,2,7.39648,3900,886,4794,0
335,3.90094,20,0,0,0,31.776,20,8190,0,0,170,0,7.51296,3900,886,4794,0
401,4.66961,28,0,0,0,62.079,28,8187,0,0,203,0,8.04877,3900,886,4794,0
339,3.94727,16,0,32,0,42.324,16,8191,32,0,149,1,7.40813,3932,887,4826,0
406,4.72811,26,0,0,0,60.456,26,8191,0,0,207,0,7.46637,3932,887,4826,0
384,4.47191,22,0,27,0,30.883,22,8191,27,0,176,1,8.87578,3959,888,4853,0
412,4.79835,28,0,1,0,56.254,29,8190,1,0,196,1,11.3452,3960,889,4854,0
335,3.90102,19,0,32,0,39.617,19,8189,32,0,148,1,12.2886,3992,890,4886,0
381,4.43665,27,0,2,0,54.651,27,8189,2,0,174,2,13.0108,3994,892,4888,0
407,4.73942,32,0,3,0,56.37,32,8189,3,0,167,3,11.2403,3997,895,4891,0
456,5.31003,37,0,3,0,61.399,37,8189,3,0,184,3,10.192,4000,898,4894,0
341,3.97078,30,0,59,0,67.617,30,8189,59,0,123,2,10.3318,4059,900,4953,0
403,4.69315,35,0,4,0,75.09,35,8189,4,0,163,4,10.2852,4063,904,4957,0
450,5.24046,55,0,6,0,84.968,72,8191,6,0,160,6,9.07379,4069,910,4963,0
463,5.39157,91,0,9,0,94.658,92,8190,9,0,53,9,8.67776,4078,919,4972,0
340,3.95916,3,0,114,0,104.661,3,8191,77,0,11,18,8.38656,4155,937,5086,0
419,4.87916,68,0,3,0,91.252,87,8191,2,0,131,3,9.12038,4157,940,5089,0
448,5.21703,100,0,17,0,131.117,106,8174,18,0,57,16,9.13203,4175,956,5106,0
286,3.33039,56,0,115,0,68.822,56,8191,108,0,63,9,9.27181,4283,965,5221,0
436,5.07734,97,0,8,0,141.066,97,8191,8,0,97,8,9.73773,4291,973,5229,0
300,3.49363,39,0,106,0,49.469,39,8189,106,0,42,8,8.1536,4397,981,5335,0
317,3.69161,28,0,55,0,66.255,28,8191,55,0,103,3,7.34989,4452,984,5390,0
437,5.08932,30,0,3,0,59.093,34,8189,3,0,181,3,7.15187,4455,987,5393,0
387,4.5068,40,0,3,0,68.04,40,8189,3,0,145,3,7.08198,4458,990,5396,0
384,4.47159,32,0,63,0,76.225,32,8191,63,0,123,3,7.61779,4521,993,5459,0
432,5.03052,37,0,4,0,62.823,37,8190,4,0,175,4,8.30502,4525,997,5463,0
419,4.87915,80,0,11,0,109.235,80,8191,11,0,112,11,10.0639,4536,1008,5474,0
511,5.95051,96,0,17,0,137.055,107,8160,17,0,80,16,11.9741,4553,1024,5491,0
334,3.88948,20,0,135,0,67.798,20,8189,90,0,30,23,10.2036,4643,1047,5626,0
469,5.4618,90,0,6,0,136.776,90,8161,6,0,123,6,9.37664,4649,1053,5632,0
430,5.00755,100,0,27,0,112.812,100,8183,27,0,31,27,8.30502,4676,1080,5659,0
261,3.03921,52,0,105,0,68.636,52,8149,64,0,57,5,8.14195,4740,1085,5764,0
422,4.91405,13,0,91,0,111.399,5,8189,65,0,77,6,8.18854,4805,1091,5855,0
360,4.19227,3,0,76,0,95.491,3,8120,64,0,92,5,8.33997,4869,1096,5931,0
349,4.0636,39,0,2,0,73.273,39,8189,2,0,144,2,10.1105,4871,1098,5933,0
329,3.83112,3,0,74,0,102.711,3,8125,74,0,46,8,10.5647,4945,1106,6007,0
192,2.23592,14,0,3,0,36.56,14,8189,3,0,97,0,9.46982,4948,1106,6010,0
413,4.80913,24,0,0,0,53.099,24,8189,0,0,209,0,10.3434,4948,1106,6010,0
407,4.73939,31,0,2,0,51.049,31,8191,2,0,179,2,10.1105,4950,1108,6012,0
404,4.70446,36,0,3,0,66.336,36,8191,3,0,172,3,10.0872,4953,1111,6015,0
393,4.57631,74,0,8,0,115.23,74,8168,8,0,124,8,10.3201,4961,1119,6023,0
332,3.86589,55,0,77,0,83.571,55,8190,61,0,99,3,10.7977,5022,1122,6100,0
466,5.42613,89,0,9,0,103.965,97,8191,9,0,98,9,11.8344,5031,1131,6109,0
343,3.99409,103,0,30,0,111.102,103,8191,30,0,21,30,11.6364,5061,1161,6139,0
414,4.82093,69,0,109,0,106.456,69,8191,103,0,88,6,11.2287,5164,1167,6248,0
232,2.70154,9,0,87,0,138.052,9,8191,65,0,36,6,10.3201,5229,1173,6335,0
477,5.55457,62,0,6,0,128.382,87,8189,6,0,125,6,8.49139,5235,1179,6341,0
428,4.98394,100,0,26,0,98.642,100,8183,26,0,40,26,7.41978,5261,1205,6367,0
405,4.71636,68,0,103,0,99.942,73,8191,103,0,98,3,7.29165,5364,1208,6470,0
452,5.26354,94,0,24,0,116.311,103,8177,24,0,81,24,6.91891,5388,1232,6494,0
294,3.42376,54,0,116,0,64.212,54,8176,104,0,60,13,6.18509,5492,1245,6610,0
439,5.11241,86,0,16,0,123.039,86,8191,16,0,71,16,5.22995,5508,1261,6626,0
305,3.55181,57,0,96,0,71.206,57,8191,72,0,65,10,5.59104,5580,1271,6722,0
438,5.10025,67,0,11,0,125.128,95,8189,11,0,90,11,6.66266,5591,1282,6733,0
300,3.49343,3,0,121,0,135.704,3,8091,81,0,19,21,7.12858,5672,1303,6854,0
440,5.12358,68,0,11,0,110.394,75,8189,10,0,102,11,8.39821,5682,1314,6865,0
374,4.35509,73,0,78,0,71.608,73,8190,62,0,99,2,11.1238,5744,1316,6943,0
388,4.51814,89,0,104,0,125.375,2,8191,73,0,41,15,11.2869,5817,1331,7047,0
348,4.05216,77,0,4,0,114.569,77,8191,5,0,107,4,9.56301,5822,1335,7051,0
466,5.42644,91,0,14,0,107.503,91,8191,14,0,38,14,7.33824,5836,1349,7065,0
333,3.8777,15,0,118,0,70.204,15,8191,82,0,26,22,6.86067,5918,1371,7183,0
366,4.26189,28,0,57,0,48.788,28,8191,57,0,129,5,7.34989,5975,1376,7240,0
437,5.0887,34,0,2,0,52.669,34,8191,2,0,191,2,8.84083,5977,1378,7242,0
412,4.79762,52,0,5,0,61.877,52,8189,5,0,153,5,9.3184,5982,1383,7247,0
335,3.90123,29,0,55,0,59.395,29,8191,55,0,119,2,7.68768,6037,1385,7302,0
429,4.99593,36,0,0,0,73.164,36,8191,0,0,220,0,7.10528,6037,1385,7302,0
458,5.3333,9,0,79,0,120.114,9,8191,66,0,140,5,8.21184,6103,1390,7381,0
402,4.68123,69,0,4,0,89.428,72,8189,4,0,125,4,6.95386,6107,1394,7385,0
411,4.78565,90,0,17,0,131.749,90,8191,17,0,45,17,7.51296,6124,1411,7402,0
336,3.91265,63,0,99,0,68.356,67,8191,67,0,89,8,7.76922,6191,1419,7501,0
356,4.14531,85,0,108,0,103.739,2,8174,81,0,43,23,9.06214,6272,1442,7609,0
354,4.1224,70,0,5,0,105.458,70,8189,6,0,91,5,9.06214,6278,1447,7614,0
241,2.80658,11,0,87,0,111.716,11,8190,66,0,32,7,9.65619,6344,1454,7701,0
406,4.72787,79,0,7,0,126.933,79,8191,7,0,102,7,9.13203,6351,1461,7708,0
348,4.05237,68,0,82,0,96.928,68,8189,62,0,86,3,8.4215,6413,1464,7790,0
427,4.97243,93,0,10,0,158.863,93,8190,10,0,63,10,8.91072,6423,1474,7800,0
368,4.28518,38,0,126,0,113.584,3,8130,100,0,19,26,8.95731,6523,1500,7926,0
447,5.20505,67,0,6,0,104.87,79,8189,30,0,111,6,9.13203,6553,1506,7932,0
437,5.08916,80,0,19,0,146.454,106,8172,19,0,77,18,8.36326,6572,1524,7951,0
271,3.15594,50,0,120,0,53.339,50,8191,73,0,55,12,8.4215,6645,1536,8071,0
371,4.32044,31,0,64,0,63.283,31,8189,64,0,123,6,8.79424,6709,1542,8135,0
344,4.00584,18,0,36,0,35.69,18,8189,36,0,137,3,8.21184,6745,1545,8171,0
413,4.80931,27,0,0,0,59.675,27,8190,0,0,211,0,8.37491,6745,1545,8171,0
433,5.04239,34,0,2,0,64.866,34,8190,2,0,190,2,7.99053,6747,1547,8173,0
371,4.3205,37,0,5,0,68.028,37,8191,5,0,123,5,8.30502,6752,1552,8178,0
306,3.56343,27,0,56,0,52.252,27,8189,56,0,94,3,8.06042,6808,1555,8234,0
323,3.76115,19,0,29,0,44.785,19,8191,29,0,146,1,8.51469,6837,1556,8263,0
394,4.58824,27,0,0,0,59.67,27,8191,0,0,200,0,9.69114,6837,1556,8263,0
379,4.41324,5,0,34,0,74.248,5,8189,34,0,173,1,10.0056,6871,1557,8297,0
398,4.63462,25,0,0,0,49.481,25,8189,0,0,198,0,9.07379,6871,1557,8297,0
438,5.10039,32,0,1,0,65.575,32,8190,1,0,209,1,10.4133,6872,1558,8298,0
439,5.11206,36,0,5,0,62.164,36,8191,5,0,158,5,9.42323,6877,1563,8303,0
463,5.39149,67,0,7,0,108.319,79,8189,7,0,117,7,10.0988,6884,1570,8310,0
405,4.71638,64,0,87,0,94.667,73,8191,85,0,116,5,11.45,6969,1575,8397,0
414,4.82099,72,0,9,0,184.236,103,8191,9,0,83,9,12.5682,6978,1584,8406,0
435,5.06583,106,0,27,0,142.732,111,8184,27,0,26,27,9.03885,7005,1611,8433,0
306,3.5637,58,0,121,0,61.51,58,8189,79,0,69,9,7.3033,7084,1620,8554,0
342,3.98258,41,0,86,0,48.864,41,8189,66,0,83,8,7.76922,7150,1628,8640,0
320,3.7263,27,0,51,0,52.452,27,8189,51,0,113,3,8.98061,7201,1631,8691,0
381,4.43665,32,0,3,0,70.218,32,8189,3,0,156,3,8.09536,7204,1634,8694,0
331,3.85442,22,0,33,0,31.271,22,8189,33,0,147,1,7.64109,7237,1635,8727,0
417,4.85573,30,0,1,0,61.494,30,8189,1,0,196,1,9.69114,7238,1636,8728,0
331,3.85444,34,0,2,0,76.823,34,8189,2,0,144,2,10.6929,7240,1638,8730,0
325,3.78457,19,0,39,0,48.094,19,8189,39,0,109,3,9.30675,7279,1641,8769,0
429,4.99558,28,0,1,0,60.369,28,8187,1,0,206,1,8.37491,7280,1642,8770,0
297,3.45849,17,0,31,0,40.042,17,8191,31,0,132,1,8.38656,7311,1643,8801,0
394,4.5884,25,0,1,0,62.707,26,8189,1,0,189,1,10.4366,7312,1644,8802,0
381,4.43668,32,0,3,0,72.236,32,8189,3,0,168,3,10.9375,7315,1647,8805,0
405,4.71617,37,0,3,0,72.23,37,8191,3,0,176,3,8.24678,7318,1650,8808,0
412,4.79795,63,0,8,0,91.13,83,8191,8,0,117,8,6.46464,7326,1658,8816,0
334,3.88952,90,0,31,0,98.111,90,8191,31,0,20,31,5.56774,7357,1689,8847,0
415,4.8331,80,0,100,0,93.216,80,8191,70,0,115,10,7.34989,7427,1699,8947,0
401,4.66989,96,0,22,0,141.158,96,8191,22,0,42,22,7.2567,7449,1721,8969,0
162,1.88658,37,0,99,0,55.538,37,8191,62,0,35,3,8.49139,7511,1724,9068,0
412,4.79774,32,0,62,0,54.929,32,8191,61,0,145,2,8.1536,7572,1726,9130,0
381,4.43668,36,0,4,0,83.009,36,8189,4,0,149,4,6.97715,7576,1730,9134,0
446,5.1935,75,0,10,0,112.085,75,8173,10,0,107,10,6.76749,7586,1740,9144,0
475,5.53157,107,0,20,0,144.223,107,8173,19,0,90,20,8.49139,7605,1760,9164,0
332,3.86633,6,0,136,0,116.587,6,8190,115,0,20,25,9.0505,7720,1785,9300,0
380,4.42522,86,0,5,0,118.766,86,8190,5,0,126,5,8.68941,7725,1790,9305,0
486,5.65899,110,0,14,0,161.161,112,8189,14,0,80,14,9.33005,7739,1804,9319,0
226,2.6317,21,0,124,0,88.957,21,8190,73,0,24,11,9.57466,7812,1815,9443,0
403,4.69277,64,0,6,0,126.461,80,8191,6,0,96,6,9.71443,7818,1821,9449,0
509,5.92715,106,0,20,0,132.719,106,8191,20,0,75,20,8.85248,7838,1841,9469,0
317,3.69138,57,0,111,0,65.409,65,8191,64,0,81,5,8.85248,7902,1846,9580,0
449,5.22869,94,0,9,0,130.077,101,8160,9,0,93,9,10.5764,7911,1855,9589,0
542,6.31185,99,0,51,0,103.801,114,8191,51,0,42,50,9.97069,7962,1905,9640,0
339,3.9478,55,0,130,0,58.932,55,8191,123,0,66,14,8.45645,8085,1919,9770,0
361,4.2037,32,0,69,0,60.189,32,8189,69,0,107,8,8.98061,8154,1927,9839,0
444,5.17023,37,0,4,0,71.159,37,8191,4,0,179,4,11.1821,8158,1931,9843,0
355,4.13391,28,0,56,0,45.643,28,8189,56,0,120,2,11.1122,8214,1933,9899,0
399,4.64671,33,0,3,0,57.101,33,8191,3,0,158,3,11.881,8217,1936,9902,0
300,3.49386,6,0,39,0,79.678,6,8189,39,0,99,3,9.26016,8256,1939,9941,0
380,4.42502,25,0,1,0,49.202,25,8189,1,0,185,1,6.89562,8257,1940,9942,0
362,4.21539,21,0,25,0,38.138,21,8191,25,0,167,0,6.90726,8282,1940,9967,0
362,4.2154,28,0,2,0,61.89,28,8165,2,0,163,2,8.736,8284,1942,9969,0
375,4.36679,4,0,35,0,65.205,4,8190,35,0,160,2,9.55136,8319,1944,10004,0
423,4.92576,25,0,0,0,45.876,25,8191,0,0,207,0,9.13203,8319,1944,10004,0
471,5.48472,33,0,1,0,57.724,33,8191,1,0,227,1,8.1536,8320,1945,10005,0
226,2.6319,9,0,38,0,30.396,9,8189,38,0,93,1,7.47802,8358,1946,10043,0
362,4.21571,21,0,0,0,45.922,21,8189,0,0,182,0,7.47802,8358,1946,10043,0
381,4.43676,28,0,30,0,57.738,2,8189,30,0,166,2,6.44134,8388,1948,10073,0
313,3.64509,21,0,0,0,45.407,21,8189,0,0,154,0,6.6976,8388,1948,10073,0
390,4.54174,29,0,1,0,68.865,29,8191,1,0,186,1,6.97715,8389,1949,10074,0
386,4.49515,34,0,4,0,57.487,34,8189,4,0,169,4,7.16352,8393,1953,10078,0
409,4.76284,63,0,3,0,89.164,63,8191,3,0,167,3,6.9655,8396,1956,10081,0
444,5.17034,76,0,8,0,133.863,102,8189,8,0,100,8,6.93056,8404,1964,10089,0
315,3.66798,4,0,129,0,132.576,4,8191,83,0,16,23,6.91891,8487,1987,10218,0
450,5.24009,80,0,5,0,97.539,84,8191,5,0,122,5,8.37491,8492,1992,10223,0
373,4.34363,100,0,10,0,112.375,100,8134,10,0,47,10,8.45645,8502,2002,10233,0
408,4.75137,73,0,105,0,103.296,73,8143,64,0,97,5,9.15533,8566,2007,10338,0
449,5.22852,90,0,14,0,126.243,90,8170,14,0,44,14,7.92064,8580,2021,10352,0
321,3.73797,52,0,103,0,58.172,52,8191,70,0,62,11,5.31149,8650,2032,10455,0
516,6.00875,100,0,14,0,100.94,100,8190,14,0,115,14,5.46291,8664,2046,10469,0
397,4.62321,105,0,125,0,124.138,2,8173,78,0,16,20,5.98707,8742,2066,10594,0
404,4.70437,65,0,7,0,101.615,75,8189,8,0,103,7,8.1536,8750,2073,10601,0
495,5.76394,62,0,12,0,135.654,107,8189,12,0,92,12,7.28,8762,2085,10613,0
378,4.40198,29,0,133,0,119.66,4,8117,118,0,28,17,7.99053,8880,2102,10746,0
431,5.0191,70,0,9,0,93.073,84,8190,9,0,123,9,8.39821,8889,2111,10755,0
377,4.38993,62,0,87,0,95.485,71,8189,61,0,93,3,9.0505,8950,2114,10842,0
467,5.43804,106,0,11,0,135.948,106,8191,11,0,97,11,8.66611,8961,2125,10853,0
291,3.38869,15,0,126,0,83.912,15,8189,75,0,24,17,9.07379,9036,2142,10979,0
439,5.11206,70,0,7,0,117.191,81,8168,7,0,104,7,9.10874,9043,2149,10986,0
494,5.75286,97,0,12,0,107.513,97,8191,12,0,46,12,9.33005,9055,2161,10998,0
306,3.56321,15,0,122,0,83.443,15,8189,94,0,24,21,10.1687,9149,2182,11120,0
468,5.44961,85,0,5,0,117.753,85,8191,5,0,115,5,9.97069,9154,2187,11125,0
462,5.37985,107,0,9,0,108.52,107,8189,9,0,65,9,10.5647,9163,2196,11134,0
305,3.5515,56,0,113,0,66.182,56,8191,64,0,66,5,10.2619,9227,2201,11247,0
322,3.74988,7,0,100,0,74.369,7,8191,98,0,96,2,9.57466,9325,2203,11347,0
391,4.55322,25,0,0,0,45.448,25,8189,0,0,196,0,7.40813,9325,2203,11347,0
418,4.86751,31,0,2,0,63.683,31,8191,2,0,188,2,7.16352,9327,2205,11349,0
423,4.92559,36,0,3,0,62.817,36,8189,3,0,168,3,8.22349,9330,2208,11352,0
375,4.36679,25,0,53,0,49.208,25,8191,53,0,120,4,8.99226,9383,2212,11405,0
380,4.42537,31,0,2,0,61.969,31,8189,2,0,171,2,10.8792,9385,2214,11407,0
395,4.59971,36,0,3,0,74.761,36,8191,3,0,162,3,12.708,9388,2217,11410,0
469,5.46172,73,0,3,0,93.676,84,8191,3,0,159,3,12.3236,9391,2220,11413,0
290,3.37709,3,0,111,0,119.994,3,8095,86,0,33,15,11.6829,9477,2235,11524,0
418,4.86733,81,0,5,0,111.254,81,8191,5,0,116,5,10.1804,9482,2240,11529,0
288,3.35366,45,0,89,0,53.354,45,8189,67,0,48,7,9.22522,9549,2247,11618,0
422,4.91437,61,0,8,0,127.049,82,8179,8,0,75,8,8.65446,9557,2255,11626,0
323,3.76125,96,0,20,0,141.079,96,8191,20,0,39,20,8.92237,9577,2275,11646,0
382,4.44809,75,0,100,0,99.471,75,8189,63,0,101,4,8.57293,9640,2279,11746,0
453,5.27527,100,0,6,0,168.713,107,8191,6,0,92,6,9.51642,9646,2285,11752,0
305,3.55153,59,0,110,0,66.54,59,8189,62,0,69,3,10.0289,9708,2288,11862,0
451,5.25172,86,0,15,0,137.675,97,8191,15,0,93,15,10.5298,9723,2303,11877,0
334,3.88951,3,0,137,0,108.22,3,8191,102,0,21,32,10.4483,9825,2335,12014,0
420,4.89094,61,0,8,0,90.387,84,8189,8,0,124,8,8.25843,9833,2343,12022,0
521,6.06734,86,0,29,0,97.456,97,8184,29,0,38,29,9.62125,9862,2372,12051,0
414,4.82124,7,0,136,0,90.493,7,8189,127,0,23,31,8.736,9989,2403,12187,0
436,5.07713,64,0,7,0,127.438,79,8191,7,0,108,7,8.08371,9996,2410,12194,0
353,4.11072,3,0,105,0,109.144,3,8105,78,0,22,18,8.72435,10074,2428,12299,0
463,5.39163,82,0,10,0,111.281,83,8189,10,0,121,10,8.78259,10084,2438,12309,0
402,4.68124,111,0,13,0,176.777,114,8191,13,0,94,13,8.39821,10097,2451,12322,0
243,2.82978,17,0,127,0,112.394,17,8189,126,0,17,13,7.0121,10223,2464,12449,0
427,4.97236,79,0,7,0,132.412,92,8189,7,0,131,7,5.87059,10230,2471,12456,0
444,5.17025,110,0,43,0,103.551,110,8189,43,0,56,42,7.8857,10273,2513,12499,0
309,3.59817,64,0,112,0,73.352,64,8191,60,0,78,2,8.1769,10333,2515,12611,0
515,5.99705,90,0,21,0,102.893,90,8178,21,0,63,21,8.43315,10354,2536,12632,0
358,4.16899,60,0,121,0,101.078,4,8164,104,0,25,23,8.43315,10458,2559,12753,0
386,4.49482,64,0,9,0,110.667,76,8189,26,0,103,9,8.28173,10484,2568,12762,0
451,5.25208,70,0,8,0,130.281,107,8127,8,0,88,8,7.79251,10492,2576,12770,0
343,3.99418,3,0,132,0,131.356,3,8081,81,0,13,22,7.51296,10573,2598,12902,0
437,5.08873,91,0,5,0,142.331,92,8191,5,0,146,5,6.48794,10578,2603,12907,0
400,4.65827,101,0,31,0,115.682,101,8185,31,0,26,29,6.6976,10609,2632,12938,0
309,3.59857,20,0,152,0,58.892,20,8189,110,0,70,2,7.10528,10719,2634,13090,0
452,5.2637,31,0,1,0,57.179,31,8191,1,0,213,1,9.42323,10720,2635,13091,0
410,4.77452,36,0,4,0,65.873,36,8191,4,0,167,4,8.78259,10724,2639,13095,0
430,5.00719,80,0,3,0,104.729,80,8189,3,0,136,3,8.39821,10727,2642,13098,0
444,5.17026,102,0,14,0,128.679,102,8189,14,0,62,14,9.46982,10741,2656,13112,0
323,3.76127,24,0,153,0,51.765,24,8191,117,0,74,2,10.5065,10858,2658,13265,0
450,5.24017,32,0,0,0,62.242,32,8189,0,0,227,0,10.192,10858,2658,13265,0
450,5.24015,37,0,3,0,72.68,37,8190,3,0,197,3,7.68768,10861,2661,13268,0
416,4.84431,59,0,6,0,133.03,91,8191,6,0,116,6,8.10701,10867,2667,13274,0
413,4.80849,99,0,40,0,105.178,99,8182,40,0,24,40,6.86067,10907,2707,13314,0
272,3.16745,56,0,107,0,72.87,56,8191,102,0,63,7,7.15187,11009,2714,13421,0
453,5.27516,91,0,10,0,122.1,91,8155,10,0,82,10,7.2567,11019,2724,13431,0
468,5.44995,99,0,22,0,122.359,107,8191,22,0,49,22,7.66438,11041,2746,13453,0
313,3.64465,9,0,136,0,105.083,9,8189,133,0,23,24,6.80243,11174,2770,13589,0
472,5.49667,90,0,10,0,95.929,90,8190,10,0,133,10,6.91891,11184,2780,13599,0
314,3.6564,4,0,110,0,103.31,4,8119,86,0,15,16,7.80416,11270,2796,13709,0
395,4.59958,28,0,56,0,56.217,28,8191,56,0,136,2,11.1122,11326,2798,13765,0
320,3.7261,18,0,32,0,39.399,18,8191,32,0,141,1,9.35334,11358,2799,13797,0
402,4.68118,27,0,1,0,57.315,27,8191,1,0,193,1,9.3417,11359,2800,13798,0
377,4.39017,32,0,2,0,64.773,32,8190,2,0,164,2,9.15533,11361,2802,13800,0
407,4.73974,37,0,6,0,66.01,37,8189,6,0,161,6,10.6812,11367,2808,13806,0
478,5.56629,81,0,6,0,123.222,81,8191,6,0,113,6,9.27181,11373,2814,13812,0
405,4.71611,106,0,13,0,167.425,110,8175,13,0,89,13,11.0423,11386,2827,13825,0
422,4.91436,118,0,42,0,116.851,118,8188,42,0,26,40,11.1471,11428,2867,13867,0
437,5.08878,62,0,185,0,72.68,3,8190,138,0,98,6,11.4267,11566,2873,14052,0
348,4.05253,33,0,4,0,75.985,33,8189,33,0,120,4,13.1273,11599,2877,14056,0
445,5.18231,51,0,3,0,72.59,51,8189,3,0,168,3,11.7645,11602,2880,14059,0
448,5.21701,97,0,10,0,130.884,97,8191,10,0,107,10,8.16525,11612,2890,14069,0
288,3.35358,53,0,101,0,50.839,54,8191,101,0,60,4,7.89734,11713,2894,14170,0
398,4.63488,81,0,10,0,136.127,81,8164,10,0,58,10,7.12858,11723,2904,14180,0
319,3.71491,22,0,97,0,68.391,22,8189,97,0,29,12,6.9888,11820,2916,14277,0
375,4.3671,26,0,45,0,52.096,26,8189,45,0,149,1,6.4297,11865,2917,14322,0
405,4.71648,32,0,3,0,64.116,32,8190,3,0,191,3,6.47629,11868,2920,14325,0
393,4.57656,37,0,2,0,97.065,37,8191,2,0,157,2,6.89562,11870,2922,14327,0
452,5.2634,68,0,12,0,95.809,74,8189,12,0,91,12,7.33824,11882,2934,14339,0
441,5.13534,89,0,12,0,145.094,107,8191,12,0,94,12,7.64109,11894,2946,14351,0
324,3.77288,48,0,121,0,50.329,48,8191,71,0,56,12,7.93229,11965,2958,14472,0
449,5.22846,75,0,3,0,134.458,102,8189,3,0,127,3,7.03539,11968,2961,14475,0
429,4.99552,113,0,40,0,134.921,113,8191,40,0,36,39,7.58285,12008,3000,14515,0
335,3.90098,67,0,119,0,75.238,67,8190,65,0,85,6,6.82573,12073,3006,14634,0
518,6.03192,88,0,19,0,101.523,91,8191,19,0,58,19,8.28173,12092,3025,14653,0
328,3.81951,54,0,105,0,66.431,54,8191,96,0,65,12,7.66438,12188,3037,14758,0
423,4.92595,84,0,11,0,133.244,84,8170,11,0,66,11,6.26662,12199,3048,14769,0
346,4.02897,52,0,96,0,59.948,52,8189,70,0,63,10,5.57939,12269,3058,14865,0
393,4.57646,32,0,60,0,63.168,32,8189,60,0,153,2,6.39475,12329,3060,14925,0
435,5.06586,37,0,4,0,60.413,37,8191,4,0,159,4,7.00045,12333,3064,14929,0
433,5.04237,65,0,7,0,108.531,75,8190,7,0,91,7,7.81581,12340,3071,14936,0
407,4.73941,64,0,9,0,165.49,103,8189,9,0,79,9,9.3417,12349,3080,14945,0
289,3.36536,29,0,117,0,67.027,29,8189,64,0,53,6,9.19027,12413,3086,15062,0
375,4.367,32,0,67,0,46.022,32,8189,60,0,106,2,9.67949,12473,3088,15129,0
395,4.59997,37,0,5,0,70.158,37,8190,5,0,151,5,9.44653,12478,3093,15134,0
456,5.30995,86,0,5,0,126.555,86,8191,5,0,132,5,6.95386,12483,3098,15139,0
469,5.46177,94,0,22,0,134.333,104,8191,22,0,52,22,6.54618,12505,3120,15161,0
363,4.22724,6,0,142,0,113.149,6,8191,142,0,23,30,7.07034,12647,3150,15303,0
433,5.04275,81,0,8,0,127.363,81,8191,8,0,114,8,9.52806,12655,3158,15311,0
501,5.83429,106,0,14,0,133.564,106,8172,14,0,72,14,10.1571,12669,3172,15325,0
319,3.71467,4,0,137,0,120.091,4,8124,120,0,17,27,10.3318,12789,3199,15462,0
488,5.68287,83,0,11,0,95.813,83,8174,11,0,121,11,10.2852,12800,3210,15473,0
336,3.91243,32,0,107,0,43.606,32,8189,81,0,43,19,8.39821,12881,3229,15580,0
438,5.10032,81,0,6,0,103.182,87,8187,6,0,102,5,7.97888,12887,3234,15586,0
389,4.53019,106,0,18,0,121.29,106,8191,18,0,58,17,8.31667,12905,3251,15604,0
417,4.85616,67,0,109,0,116.548,74,8189,105,0,99,3,7.97888,13010,3254,15713,0
322,3.74974,8,0,100,0,108.883,8,8191,100,0,50,9,8.57293,13110,3263,15813,0
404,4.70443,75,0,7,0,131.454,75,8191,7,0,96,7,9.79597,13117,3270,15820,0
469,5.46124,95,0,13,0,111.354,95,8191,13,0,54,13,10.7278,13130,3283,15833,0
393,4.57636,4,0,131,0,96.933,4,8136,124,0,22,29,9.91245,13254,3312,15964,0
386,4.49478,75,0,9,0,110.634,75,8180,9,0,99,9,9.22522,13263,3321,15973,0
488,5.68275,93,0,13,0,124.883,93,8177,13,0,48,13,7.78086,13276,3334,15986,0
518,6.03224,104,0,54,0,99.005,106,8181,54,0,41,51,7.62944,13330,3385,16040,0
323,3.76154,62,0,120,0,83.254,62,8189,107,0,77,13,8.86413,13437,3398,16160,0
275,3.20244,32,0,65,0,64.834,32,8191,63,0,87,3,10.2968,13500,3401,16225,0
436,5.07704,37,0,5,0,64.563,37,8155,5,0,146,5,10.4716,13505,3406,16230,0
365,4.25035,24,0,38,0,47.553,24,8191,9,0,173,1,10.2502,13514,3407,16268,0
430,5.00731,31,0,1,0,60.74,31,8189,1,0,204,1,8.87578,13515,3408,16269,0
339,3.94761,15,0,37,0,59.503,15,8191,37,0,121,3,9.42323,13552,3411,16306,0
406,4.72775,26,0,0,0,48.661,26,8189,0,0,204,0,9.59795,13552,3411,16306,0
428,4.98425,32,0,2,0,63.457,32,8189,2,0,186,2,10.5065,13554,3413,16308,0
389,4.53013,3,0,40,0,75.854,3,8155,40,0,131,4,10.5764,13594,3417,16348,0
362,4.21549,25,0,0,0,54.163,25,8189,0,0,177,0,9.56301,13594,3417,16348,0
362,4.21548,30,0,2,0,65.233,30,8189,2,0,156,2,8.77094,13596,3419,16350,0
415,4.83286,35,0,3,0,59.843,35,8189,3,0,164,3,9.99398,13599,3422,16353,0
369,4.29694,64,0,7,0,88.169,64,8171,7,0,121,7,8.32832,13606,3429,16360,0
385,4.48326,35,0,66,0,68.169,35,8191,60,0,136,2,9.13203,13666,3431,16426,0
400,4.65804,6,0,59,0,82.464,6,8191,59,0,132,5,9.33005,13725,3436,16485,0
433,5.04217,32,0,1,0,69.971,32,8191,1,0,197,1,8.07206,13726,3437,16486,0
391,4.55337,17,0,40,0,58.514,17,8189,40,0,146,4,7.8857,13766,3441,16526,0
391,4.55337,26,0,1,0,57.213,26,8189,1,0,187,1,8.47974,13767,3442,16527,0
394,4.58811,31,0,3,0,63.2,31,8189,3,0,159,3,10.2735,13770,3445,16530,0
383,4.45989,36,0,3,0,77.629,36,8191,3,0,145,3,7.96723,13773,3448,16533,0
426,4.96063,67,0,5,0,115.336,71,8189,5,0,127,5,7.0121,13778,3453,16538,0
506,5.892,96,0,18,0,107.221,96,8169,18,0,66,18,7.31494,13796,3471,16556,0
380,4.42516,69,0,103,0,96.634,74,8189,66,0,100,7,8.38656,13862,3478,16659,0
439,5.11248,100,0,23,0,125.789,100,8191,23,0,70,23,9.51642,13885,3501,16682,0
310,3.61005,56,0,105,0,90.493,60,8191,64,0,71,5,8.00218,13949,3506,16787,0
431,5.01879,97,0,8,0,147.101,97,8189,8,0,91,8,8.52634,13957,3514,16795,0
348,4.05238,61,0,100,0,92.075,63,8191,62,0,77,3,9.2951,14019,3517,16895,0
392,4.56469,86,0,15,0,132.505,86,8170,15,0,55,15,9.16698,14034,3532,16910,0
528,6.14851,97,0,26,0,98.887,97,8179,26,0,30,26,7.50131,14060,3558,16936,0
321,3.73811,59,0,104,0,74.873,59,8189,82,0,68,7,6.76749,14142,3565,17040,0
464,5.40312,75,0,8,0,124.681,91,8191,8,0,76,8,7.85075,14150,3573,17048,0
366,4.26195,3,0,120,0,104.119,3,8094,84,0,18,23,8.56128,14234,3596,17168,0
470,5.47304,85,0,9,0,115.746,87,8189,9,0,133,9,8.57293,14243,3605,17177,0
258,3.00441,105,0,10,0,151.588,105,8176,10,0,52,10,8.45645,14253,3615,17187,0
409,4.76245,73,0,106,0,124.388,79,8189,60,0,113,1,8.67776,14313,3616,17293,0
477,5.55457,97,0,9,0,126.982,106,8190,9,0,76,9,8.77094,14322,3625,17302,0
451,5.25159,101,0,27,0,157.018,121,8191,27,0,56,27,8.37491,14349,3652,17329,0
383,4.46022,36,0,161,0,108.122,5,8139,154,0,26,33,6.83738,14503,3685,17490,0
310,3.61003,23,0,36,0,49.076,23,8189,36,0,132,0,5.81235,14539,3685,17526,0
452,5.26386,31,0,0,0,51.908,31,8191,0,0,227,0,6.4297,14539,3685,17526,0
427,4.97248,36,0,4,0,65.592,36,8191,4,0,152,4,8.01382,14543,3689,17530,0
466,5.42665,78,0,7,0,102.099,85,8191,7,0,155,7,7.75757,14550,3696,17537,0
524,6.10177,95,0,25,0,91.149,97,8189,25,0,37,25,8.04877,14575,3721,17562,0
367,4.27382,7,0,133,0,94.087,7,8189,127,0,22,29,8.00218,14702,3750,17695,0
507,5.90388,67,0,6,0,84.8,91,8189,6,0,140,6,9.3417,14708,3756,17701,0
387,4.50646,40,0,107,0,104.807,3,8135,107,0,14,11,9.57466,14815,3767,17808,0
416,4.84434,60,0,6,0,123.487,83,8191,6,0,122,6,9.26016,14821,3773,17814,0
361,4.20391,96,0,19,0,131.598,96,8178,19,0,35,19,8.1769,14840,3792,17833,0
386,4.49473,74,0,100,0,97.401,74,8191,71,0,99,4,7.51296,14911,3796,17933,0
451,5.25173,96,0,11,0,141.516,99,8191,11,0,69,11,9.12038,14922,3807,17944,0
333,3.87754,64,0,107,0,80.304,64,8190,66,0,80,7,8.23514,14988,3814,18051,0
494,5.75256,80,0,10,0,124.537,100,8191,10,0,94,10,7.34989,14998,3824,18061,0
463,5.39173,108,0,24,0,110.378,108,8191,24,0,26,23,8.4448,15022,3847,18085,0
272,3.16764,3,0,164,0,58.946,3,8139,114,0,57,4,9.16698,15136,3851,18249,0
338,3.93581,30,0,1,0,49.03,30,8189,1,0,151,1,9.48147,15137,3852,18250,0
429,4.99562,35,0,4,0,68.187,35,8156,4,0,170,4,8.74765,15141,3856,18254,0
338,3.93604,20,0,39,0,47.835,20,8189,39,0,131,2,9.23686,15180,3858,18293,0
382,4.44817,28,0,1,0,50.198,28,8191,1,0,182,1,9.14368,15181,3859,18294,0
433,5.04176,33,0,3,0,63.647,33,8189,3,0,179,3,7.96723,15184,3862,18297,0
417,4.85615,46,0,4,0,70.988,46,8189,4,0,160,4,8.25843,15188,3866,18301,0
436,5.07706,68,0,8,0,133.361,86,8191,8,0,84,8,8.96896,15196,3874,18309,0
492,5.72938,99,0,20,0,129.423,103,8176,20,0,49,20,8.70106,15216,3894,18329,0
332,3.86603,9,0,134,0,98.852,9,8189,120,0,24,26,8.30502,15336,3920,18463,0
475,5.53109,91,0,7,0,123.59,92,8191,7,0,139,7,7.71098,15343,3927,18470,0
486,5.65935,94,0,29,0,98.386,102,8177,28,0,30,29,7.95558,15371,3956,18499,0
337,3.9244,44,0,112,0,81.011,58,8156,107,0,66,10,6.90726,15478,3966,18611,0
354,4.12239,57,0,81,0,60.046,57,8189,63,0,105,4,8.77094,15541,3970,18692,0
409,4.76316,93,0,7,0,151.349,93,8189,7,0,85,7,7.95558,15548,3977,18699,0
495,5.76466,101,0,21,0,122.797,101,8191,21,0,24,21,8.02547,15569,3998,18720,0
322,3.74974,52,0,115,0,58.663,52,8189,72,0,65,12,7.94394,15641,4010,18835,0
367,4.27379,30,0,52,0,52.566,30,8189,52,0,150,0,7.67603,15693,4010,18887,0
390,4.54152,35,0,3,0,85.356,35,8190,3,0,168,3,7.61779,15696,4013,18890,0
383,4.45992,57,0,5,0,66.147,57,8189,5,0,118,5,8.94566,15701,4018,18895,0
473,5.50798,89,0,8,0,125.253,103,8191,8,0,117,8,7.8624,15709,4026,18903,0
342,3.98278,42,0,113,0,48.666,42,8191,104,0,47,8,7.89734,15813,4034,19016,0
494,5.75265,64,0,10,0,102.032,82,8191,10,0,79,10,8.60787,15823,4044,19026,0
445,5.18187,74,0,8,0,143.548,107,8191,8,0,74,8,9.45818,15831,4052,19034,0
333,3.87767,42,0,117,0,46.372,42,8191,102,0,45,9,8.30502,15933,4061,19151,0
435,5.0656,87,0,5,0,119.237,93,8189,5,0,109,5,9.16698,15938,4066,19156,0
375,4.36693,3,0,128,0,126.726,3,8083,79,0,47,20,7.53626,16017,4086,19284,0
281,3.27219,19,0,59,0,64.137,19,8189,59,0,81,2,7.44307,16076,4088,19343,0
361,4.20376,32,0,2,0,62.337,32,8189,2,0,152,2,7.31494,16078,4090,19345,0
362,4.21554,3,0,39,0,73.948,3,8155,39,0,147,3,9.0039,16117,4093,19384,0
428,4.98401,26,0,0,0,42.693,26,8189,0,0,209,0,10.1687,16117,4093,19384,0
377,4.39036,31,0,4,0,65.152,31,8160,4,0,148,4,11.4849,16121,4097,19388,0
383,4.46001,36,0,4,0,68.984,36,8189,4,0,147,4,10.0406,16125,4101,19392,0
402,4.68122,27,0,58,0,51.959,27,8189,58,0,122,3,8.27008,16183,4104,19450,0
385,4.48361,9,0,34,0,65.62,9,8189,34,0,162,2,7.52461,16217,4106,19484,0
420,4.89085,25,0,0,0,40.645,25,8191,0,0,210,0,7.04704,16217,4106,19484,0
389,4.52981,31,0,2,0,58.985,31,8191,2,0,170,2,7.85075,16219,4108,19486,0
353,4.11064,35,0,5,0,66.873,35,8189,5,0,118,5,9.20192,16224,4113,19491,0
326,3.7962,23,0,35,0,49.092,23,8189,35,0,140,0,9.6096,16259,4113,19526,0
447,5.20567,31,0,0,0,64.021,31,8189,0,0,226,0,8.09536,16259,4113,19526,0
388,4.51823,35,0,4,0,76.112,35,8189,4,0,136,4,7.66438,16263,4117,19530,0
489,5.69432,65,0,5,0,104.399,82,8191,5,0,174,5,8.95731,16268,4122,19535,0
295,3.43514,49,0,90,0,50.506,49,8191,65,0,57,6,11.8344,16333,4128,19625,0
333,3.87771,30,0,58,0,59.519,30,8190,58,0,113,2,9.37664,16391,4130,19683,0
386,4.49467,35,0,4,0,101.33,35,8191,4,0,167,4,8.08371,16395,4134,19687,0
365,4.25038,23,0,38,0,36.469,23,8189,38,0,144,2,6.31322,16433,4136,19725,0
434,5.05416,30,0,2,0,57.349,30,8189,2,0,194,2,5.97542,16435,4138,19727,0
477,5.55482,37,0,1,0,71.976,37,8191,1,0,224,1,5.49786,16436,4139,19728,0
370,4.30857,79,0,7,0,107.661,79,8189,7,0,111,7,9.55136,16443,4146,19735,0
284,3.30728,11,0,99,0,126.58,11,8191,68,0,37,9,10.9142,16511,4155,19834,0
421,4.90245,86,0,7,0,118.909,86,8191,7,0,122,7,8.99226,16518,4162,19841,0
382,4.44832,98,0,12,0,139.864,98,8161,12,0,35,12,7.09363,16530,4174,19853,0
354,4.12209,70,0,100,0,79.811,70,8191,62,0,91,2,6.89562,16592,4176,19953,0
318,3.70305,36,0,73,0,62.028,36,8191,61,0,99,3,7.5945,16653,4179,20026,0
432,5.03037,82,0,5,0,95.195,82,8191,5,0,127,5,8.74765,16658,4184,20031,0
446,5.19358,92,0,11,0,144.07,104,8191,11,0,63,11,7.71098,16669,4195,20042,0
298,3.47014,4,0,124,0,120.956,4,8098,84,0,11,18,7.5479,16753,4213,20166,0
498,5.79932,59,0,7,0,93.213,87,8189,7,0,132,7,8.52634,16760,4220,20173,0
194,2.25907,9,0,98,0,34.258,9,8189,90,0,43,4,7.0121,16850,4224,20271,0
361,4.20368,21,0,0,0,42.186,21,8189,0,0,183,0,8.1303,16850,4224,20271,0
399,4.64619,28,0,1,0,59.429,28,8189,1,0,191,1,7.67603,16851,4225,20272,0
365,4.25033,33,0,5,0,79.567,33,8189,5,0,141,5,7.64109,16856,4230,20277,0
436,5.07671,37,0,4,0,70.32,37,8191,4,0,157,4,8.1769,16860,4234,20281,0
499,5.81092,71,0,6,0,153.695,95,8189,6,0,126,6,10.3434,16866,4240,20287,0
286,3.33054,14,0,113,0,108.884,14,8189,82,0,30,12,12.4168,16948,4252,20400,0
438,5.10057,66,0,5,0,109.236,83,8189,5,0,110,5,13.302,16953,4257,20405,0
356,4.1458,105,0,10,0,144.209,105,8191,10,0,65,10,12.4983,16963,4267,20415,0
399,4.64626,77,0,108,0,91.89,77,8189,63,0,107,3,10.5647,17026,4270,20523,0
375,4.36681,58,0,80,0,86.821,65,8191,62,0,81,3,7.66438,17088,4273,20603,0
470,5.47171,109,0,11,0,156.077,109,8183,11,0,118,11,7.87405,17099,4284,20614,0
344,4.00521,114,0,30,0,120.737,114,8173,30,0,20,30,8.86413,17129,4314,20644,0
407,4.73955,72,0,118,0,88.047,72,8189,104,0,96,4,8.27008,17233,4318,20762,0
457,5.32098,93,0,22,0,124.975,93,8164,22,0,55,22,7.60614,17255,4340,20784,0
224,2.6086,48,0,96,0,50.633,48,8189,60,0,52,2,6.52288,17315,4342,20880,0
447,5.20552,56,0,7,0,120.936,95,8189,7,0,106,7,7.89734,17322,4349,20887,0
347,4.04099,107,0,25,0,147.181,107,8180,25,0,36,24,7.73427,17347,4373,20912,0
314,3.65679,18,0,135,0,42.172,18,8191,119,0,96,0,7.8624,17466,4373,21047,0
347,4.04076,20,0,18,0,45.747,20,8189,18,0,174,0,6.88397,17484,4373,21065,0
420,4.89083,28,0,1,0,49.781,28,8189,1,0,201,1,6.93056,17485,4374,21066,0
394,4.58805,33,0,4,0,72.956,33,8190,4,0,158,4,7.45472,17489,4378,21070,0
339,3.94759,21,0,35,0,51.74,21,8189,35,0,134,1,7.18682,17524,4379,21105,0
434,5.05385,29,0,1,0,60.394,29,8191,1,0,208,1,8.39821,17525,4380,21106,0
408,4.75109,35,0,3,0,67.544,35,8191,3,0,181,3,9.43488,17528,4383,21109,0
374,4.35513,24,0,35,0,43.912,24,8189,35,0,165,0,9.83091,17563,4383,21144,0
451,5.25178,31,0,1,0,64.287,31,8189,1,0,214,1,10.2735,17564,4384,21145,0
403,4.69282,36,0,4,0,67.197,36,8189,4,0,156,4,8.36326,17568,4388,21149,0
358,4.16888,23,0,39,0,44.467,23,8191,39,0,156,2,8.95731,17607,4390,21188,0
410,4.77434,30,0,1,0,47.051,30,8191,1,0,198,1,8.1536,17608,4391,21189,0
438,5.10029,36,0,4,0,70.016,36,8190,4,0,190,4,8.49139,17612,4395,21193,0
443,5.15854,62,0,6,0,126.187,80,8189,6,0,147,6,7.45472,17618,4401,21199,0
306,3.56332,19,0,97,0,66.419,19,8191,72,0,27,13,7.89734,17690,4414,21296,0
455,5.29839,78,0,12,0,126.974,83,8171,12,0,105,12,5.71917,17702,4426,21308,0
516,6.00871,102,0,23,0,119.449,113,8191,23,0,92,21,8.87578,17725,4447,21331,0
337,3.92429,47,0,126,0,46.483,47,8189,70,0,54,11,9.94739,17795,4458,21457,0
389,4.52982,90,0,10,0,143.045,90,8191,10,0,92,10,11.7062,17805,4468,21467,0
490,5.70579,107,0,25,0,127.8,107,8180,25,0,55,25,10.7511,17830,4493,21492,0
326,3.79633,52,0,112,0,74.684,69,8191,112,0,88,5,8.95731,17942,4498,21604,0
491,5.71765,60,0,9,0,93.98,100,8191,9,0,84,9,8.4681,17951,4507,21613,0
238,2.77145,17,0,110,0,91.237,17,8189,65,0,25,6,8.40986,18016,4513,21723,0
376,4.37845,80,0,7,0,121.799,80,8178,7,0,99,7,8.07206,18023,4520,21730,0
298,3.47008,69,0,82,0,99.903,69,8191,61,0,88,2,7.8391,18084,4522,21812,0
386,4.49486,3,0,106,0,158.421,3,8165,64,0,86,5,8.04877,18148,4527,21918,0
231,2.68992,7,0,51,0,42.385,7,8189,51,0,70,1,7.95558,18199,4528,21969,0
300,3.4936,18,0,0,0,36.807,18,8189,0,0,152,0,6.28992,18199,4528,21969,0
458,5.33365,28,0,0,0,47.371,28,8191,0,0,228,0,7.58285,18199,4528,21969,0
389,4.52987,33,0,2,0,63.172,33,8191,2,0,172,2,8.32832,18201,4530,21971,0
447,5.20523,58,0,4,0,81.223,59,8191,4,0,177,4,9.86586,18205,4534,21975,0
416,4.84417,102,0,9,0,128.745,102,8189,9,0,108,9,9.9008,18214,4543,21984,0
341,3.97109,66,0,106,0,101.276,66,8191,64,0,83,4,8.31667,18278,4547,22090,0
471,5.48468,69,0,23,0,92.865,88,8173,23,0,53,23,8.21184,18301,4570,22113,0
479,5.57789,86,0,17,0,122.708,105,8165,17,0,51,17,8.35162,18318,4587,22130,0
421,4.9026,3,0,141,0,110.527,3,8080,89,0,22,30,8.50304,18407,4617,22271,0
396,4.61129,86,0,4,0,118.141,86,8191,4,0,129,4,8.64282,18411,4621,22275,0
307,3.57497,15,0,139,0,68.275,15,8190,74,0,70,1,7.95558,18485,4622,22414,0
272,3.16738,16,0,28,0,53.952,16,8189,28,0,114,1,7.45472,18513,4623,22442,0
331,3.85444,24,0,0,0,46.318,24,8189,0,0,167,0,6.9655,18513,4623,22442,0
447,5.20523,32,0,2,0,61.09,32,8190,2,0,210,2,6.95386,18515,4625,22444,0
193,2.24767,8,0,38,0,38.856,8,8189,38,0,64,1,6.3831,18553,4626,22482,0
288,3.35398,19,0,0,0,37.615,19,8189,0,0,148,0,6.35981,18553,4626,22482,0
445,5.1819,28,0,0,0,53.813,28,8189,0,0,225,0,7.68768,18553,4626,22482,0
426,4.96099,34,0,2,0,56.985,34,8189,2,0,187,2,8.01382,18555,4628,22484,0
413,4.80938,4,0,58,0,76.742,4,8191,51,0,156,2,7.3033,18606,4630,22542,0
336,3.91267,32,0,1,0,70.059,32,8190,1,0,159,1,7.8391,18607,4631,22543,0
380,4.42502,8,0,39,0,71.859,8,8190,39,0,142,3,8.10701,18646,4634,22582,0
399,4.6462,26,0,0,0,55.905,26,8191,0,0,198,0,9.12038,18646,4634,22582,0
372,4.33184,31,0,3,0,64.539,31,8189,3,0,151,3,8.52634,18649,4637,22585,0
376,4.37865,36,0,3,0,90.993,36,8190,3,0,161,3,7.66438,18652,4640,22588,0
408,4.75084,27,0,56,0,45.385,27,8189,56,0,128,2,7.15187,18708,4642,22644,0
419,4.87914,34,0,1,0,73.811,34,8191,1,0,202,1,6.95386,18709,4643,22645,0
412,4.79765,62,0,1,0,75.137,63,8189,1,0,178,1,7.74592,18710,4644,22646,0
444,5.17048,74,0,11,0,129.224,92,8156,11,0,71,11,8.18854,18721,4655,22657,0
313,3.64504,37,0,111,0,41.563,37,8189,75,0,42,16,7.72262,18796,4671,22768,0
469,5.46106,69,0,8,0,116.429,85,8191,8,0,92,8,7.79251,18804,4679,22776,0
448,5.21668,115,0,9,0,160.955,115,8189,9,0,94,9,10.4366,18813,4688,22785,0
296,3.44685,52,0,118,0,69.334,52,8191,62,0,58,3,9.44653,18875,4691,22903,0
458,5.33352,96,0,10,0,123.027,96,8191,10,0,101,10,10.5065,18885,4701,22913,0
536,6.24152,124,0,8,0,138.978,124,8188,8,0,98,8,10.0872,18893,4709,22921,0
473,5.50791,129,0,6,0,210.048,148,8189,6,0,100,6,11.0307,18899,4715,22927,0
212,2.46875,14,0,163,0,183.248,14,8189,66,0,46,8,11.1704,18965,4723,23090,0
393,4.57622,30,0,62,0,52.847,30,8189,62,0,119,3,8.98061,19027,4726,23152,0
434,5.05384,36,0,0,0,58.642,36,8190,0,0,221,0,7.99053,19027,4726,23152,0
392,4.56472,29,0,62,0,55.598,29,8189,62,0,127,4,8.24678,19089,4730,23214,0
302,3.51672,20,0,29,0,41.56,20,8189,29,0,133,0,9.08544,19118,4730,23243,0
410,4.77426,29,0,0,0,67.058,29,8189,0,0,207,0,10.2619,19118,4730,23243,0
419,4.87918,34,0,2,0,64.237,34,8191,2,0,180,2,13.2554,19120,4732,23245,0
482,5.61275,58,0,4,0,85.807,63,8189,4,0,157,4,10.7511,19124,4736,23249,0
372,4.33189,95,0,12,0,137.039,95,8173,12,0,77,12,10.0639,19136,4748,23261,0


